21cm line|21cm파|중성 수소의 양성자와 전자 스핀이 평행에서 역전되면서 만들어 내는 21.11cm의 방출선.
Aberration Of Starlight |별빛의 광행차|빛이 한정된 속도를 가진다는 사실때문에 생기는 하늘에서의 별의 겉보기 이동현상. 지구는 태양의 주위를 돌며, 이 때문에 별빛은 "기울어진 상태"로 지구에 도달하는 것처럼 된다. 별들의 겉보기 위치는 20.5초각까지 영향을 받을 수 있다.
Absolute Magnitude |절대 등급|10파섹, 즉 32.6광년이라는 표준 거리에서 관측되었을때, 별이 가지는 겉보기 등급. 태양의 절대 등급은 +4.8이다
Absorption Of Light In Space |우주내의 빛의 흡수|우주는 일반적으로 생각되어 왔던 완전히 비어있는 상태가 아니다. 상당한 양의 물질이 행성 사이에 퍼져 있으며, 또한 항성들 사이에도 있다; 멀리 떨어진 천체에서 나오는 빛은 이것 때문에 흡수되고 붉은 색으로 변한다. 이 효과는 매우 멀리 있는 천체에 대한 모든 연구에 반드시 고려되어야 한다.
Absorption Spectrum |흡수 스펙트럼|밝고 연속적인 배경에 대해 어두운 선들로 구성된 스펙트럼. 태양은 흡수 스펙트럼을 가진다; 밝은 배경, 즉 연속 스펙트럼은 태양의 빛나는 표면(광구, Photosphere)에서 발생한 것이지만, 반면에 어두운 흡수선들은 태양의 대기에서 생겨난 것이다. 이러한 어두운 선들은 태양 대기 안의 원자들이 광구의 연속 스펙트럼으로부터 어떤 특징적인 파장들을 흡수하기 때문에 발생한다.
accretion disk|강착 원반|주변물질들이 떨어지면서 만든 원반. 각운동량 보존이 이러한 모양을 만들어낸다.
adiabatic perturbation|단열 섭동|우주 진화 초기에 복사/물질 혼합체 속에서 일어나는 복사와 물질의 작은 변화.
Aerolite|석질 운석|조직이 돌로 되어 있는 운석
Aeropause|대기 계면, 大氣界面|공기의 밀도가 실제적으로 무시 될만큼 적게 되어있는 대기권의 지역을 나타내기 위해 사용되는 용어. 그곳은 뚜렷한 경계가 없으며, 단지 "대기권"과 "우주" 사이에 있는 전이 지역이다.
Airglow|야광, 夜光|지구의 상층대기 안에서의 반응때문에 생긴 희미한 자연적인 발광 현상.
Airy Disk|에어리 디스크, 공기의 원반|완벽한 광학계에서도 발생하는 별의 원반 상의 겉보기 크기. 별은 완벽하게 초점을 맺게 할 수 없기 때문에, 빛의 84%는 하나의 원반에 모이며 16%는 주변의 고리 조직으로 모인다.
albedo|반사도|물체의 반사의 정도를 말한다. 고체 표면에 들어오는 빛과 반사하는 빛의 비율, 완전히 반사될 때에는 그 값이 1이다.
alpha Centarus|알파 센타우르스|태양에서 가장 가까운 별로 삼중성이다. 별 A는 광도와 표면온도가 태양과 거의 같다.
alpha particle|알파 입자|무거운 원소들이 방사성 붕괴를 일으키면서 내놓은 헬륨 원자핵.
Altazimuth Mount|경위의식 가대, 경위대|고도(Altitude)와 방위(Azimuth) 양 쪽 방향으로 자유롭게 움직이는, 망원경을 지지하는 기구. 현대의 컴퓨터들은 이런 종류의 망원경들을 효율적으로 움직이게 하는 것을 가능하게 하고 있으며, 대부분의 신형 대구경 망원경들이 경위의식 가대로 설치되고 있다.
Altitude|고도|지평선 위에 있는 천체의 각거리이며, 지평선에서의 0도의 값에서 천정(Zenith)까지의 90도의 값의 범위를 가진다.
Angstrom Unit|옹스트롬 단위|빛의 파장과 그 밖의 전자기 진동을 측정하기 위한 단위. 이것은 1억 분의 일㎝와 같다. 가시 광선의 범위는 대략 7500옹스트롬(빨강색) 에서 3900옹스트롬(보라색) 까지이다.
Anomalistic Month|근점월近點月|한 근지점(Perigee)에서 다음 근지점까지 달이 움직이는데 걸리는 시간.
Anomalistic Year|근점년|지구가 근일점을 통과하고 다시 근일점을 통과하기까지 걸리는 시간. 이것은 365일 6시간 13분 53초이다. 근점년은, 해마다 근일점의 위치가 11˝각 정도 움직이기 때문에, 항성년보다 약간 더 길다.
anorthosite|아노소사이트|칼슘, 나트륨, 알루미늄, 규산염으로 이루어진 현무암질 광물로 달에 많이 있다.
Antenna|안테나|전파를 송수신하기 위한 도선이나 도선의 조직. 감도의 증가나 방향탐지의 효과를 얻기 위해 함께 연결된 안테나의 조직은 빔 안테나(Antenna Array) 또는 전파 천문학(Radio Astronomy) 에서 사용될 때는 전파 망원경이라 부른다.
antiparticles|반입자|"정상입자"와 충돌해서 쌍소멸하는 아(亞)원자 입자.한 예로, 양전자가 있으며 이는 전자와 반대인 전하를 가진 입자이다.
Apastron|원성점|각각 서로의 별들이 가장 멀리 떨어져 있는 때의 연성(Binary)계의 궤도내의 지점. 가장 가까운 지점은 근성점(Periastron)으로 알려져 있다.
aperture synthesis|구경 합성|최대한 넓은 범위에서 높은 분해능을 얻기 위해 전파 안테나 배열에 사용하는 간섭계 기술.
aphelion|원일점|태양을 도는 천체가 태양에서 가장 멀어지는 점. 가장 가까운 지점은 근일점(Perihelion)
Aphrodite Terra|아프로디테 고원|금성에 있는 넓은 고원 지역.
apogee|원지점|지구를 도는 위성이 궤도상에서 지구에서 가장 멀어지는 점.
apparent magnitude|실시등급|지상에서 등급 척도를 가지고 측정한 별(혹은 천체)의 밝기; 천체의 복사속에 대한 천문학적 척도.
Apperent Or Visual Magnitude|겉보기 등급 또는 안시 등급|눈으로 보았을 때 천체의 겉보기 밝기. 더 밝은 물체일수록 더 낮은 등급을 가진다. 금성은 대략 -4등급정도이다. 가장 밝은 별인 시리우스(Sirius)는 -1.4등급이다. 그리고 북극성은 +2등급정도이며 맨눈으로 간신히 볼 수 있는 별들은 +6등급정도이다. 세계에서 가장 큰 망원경을 써야 기록될 수 있는 가장 희미한 별은 +20등급정도가 된다. 별의 겉보기 등급은 그 광대에 대해 믿을만한 실마리는 되지 않는다. 왜냐하면 거리에 따라서 밝기가 틀려지기 때문이다.
arroyo|좁은 수로|가끔씩 발생하는 물의 흐름 때문에 땅바닥에 패어진 물길.
Ashen Light|애션 라이트, 잿빛 현상|금성이 초승달 모양의 단계일때 보이는, 금성의 밤 부분에서의 희미한 발광현상. 그것은 아마도 명암 효과라기보다는 오히려 진짜 발생하는 현상 같지만, 그 원인은 확실하게 알려져 있지 않다.
asteroid belt|소행성대|화성과 목성 궤도 사이에 소행성이 많이 몰려있는 지역.
Asteroids|소행성|작은 행성들이며, 대부분이 화성과 목성 궤도 사이에서 태양 주위를 돌고 있다. 수 천개의 소행성들이 알려져 있다; 가장 큰 것은 세레스(Ceres)이며, 그 직경은 1003㎞이다. 단지 하나의 소행성-베스타(Vesta)-만이 항상 맨눈으로 볼 수 있다.
Astrology|점성학|행성들의 위치와 인간의 운명들이 이어져 있다고 주장하는 유사 과학. 이것은 전혀 과학적인 근거가 없다. (Patrick Moore의 주장입니다. 과학적 근거는 없지만 체계적으로 되어있다는 점에서는 나름대로 재미있는 학문이라고 저는 생각하거든요.)
astronomical unit, AU|천문 단위|지구 궤도의 긴 반지름이며, 태양과 지구의 평균 거리이다. 1억 4960만 km 또는 8.3 광분이다.
AU|astronomical unit의 줄임말|천문단위 1.5*1011km 태양에서 지구까지의 거리.
astrophysical jets|천체물리학적 제트|활동 은하의 핵과 같은 천체 물리학적 천체에서 뿜어져 나온 물질(보통 이온과 전자)의 다발.
Astrophysics|천체물리학|천문학에 모든 부문에 걸친 물리학의 법칙들과 원리들의 적용, 이것은 한때 "행성들의 물리학과 화학"으로 정의 되었다.
Atmosphere|대기권|행성이나 다른 천체를 둘러싸고 있는 기체의 막. 그것은 한정된 경계를 가지는 것이 아니라, 단지 주위 우주공간의 밀도보다 더 많아지지 않을때까지 희박해질 뿐이다.
atmosphere|대기|행성 혹은 별의 보이는 층을 둘러싸는 기체 껍질. 또한 기압의 단위(atm). 해발 기준으로 지구 표면 대기압이다.
atmosphere extinction|대기 소광|대기를 통과하면서 빛의 양이 줄어드는 현상.
atmospheric escape|대기 탈출|외기권에 있는 입자가 탈출속도를 능가하여 행성을 떠나는 과정.
atmospheric reddening|대기 적색화|대기 입자가 푸른색을 붉은색 보다 더 잘 산란시키기 때문에 천체가 실제보다 더 붉어 보이는 현상.
atom|원자|화학적 성질을 보여주는 가장 작은 단위 입자.
aurora|극광|대기 중에 있는 원자나 분자가 자기권에서 온 강한 대전 입자와 충돌하여 가시광선 영역에서 내는 방출 현상.
Aurorae,Polar Light|오로라,극광極光|오로로 보레알리스(Aurora Borealis, 북극광)은 북반구에, 오로라 아우스트랄리스(Aurora Australis, 남극광)은 남반구에 나타난다. 그것들은 상층대기에 있는 빛이며, 태양에 의해 방출된 대전된 입자 때문에 발생한다. 입자들은 전기적으로 대전되었기 때문에, 자극(磁極, Magnetic Pole)으로 끌리는 경향이 있고, 그래서 오로라들은 극지방에서 가장 잘 보인다.
axis|축|좌표계에서 쓰이는 두 개 이상의 기준선.
Azimuth|방위각|관측자의 지평선 북쪽 점에서 계산되는 천체의 가로 방향, 즉 방위의 위치. 지구의 자전때문에, 한 천체의 방위각은 항상 변화하게 된다.
Background Radiation|배경복사|끊임없이 모든 방향으로부터 절대 영도보다 3도 높은 전반적인 온도를 나타내고 있는, 우주에서 오는 매우 약한 극초단파(Microwave). 이것은 대략 150억년전에 우주가 생성되었던 대 폭발(Big Bang)의 마지막 흔적으로 믿어지고 있다. 코비 위성(COBE Satellite, Cosmic Background Explorer Satellite)은 배경복사에서의 미세한 진동을 발견하였다.
Baily's Beads|베일리의 목걸이|개기 일식때, 개기 식이 끝나기 직전이나 그 직후에 달의 원반상의 가장자리를 따라서 보이는 밝은 점들. 그것들은 달 가장자리의 계곡지역과 산맥지역 사이를 통해서 햇빛이 비치기 때문에 일어나는 것이다.
Balmer jump; Balmer edge|발머 도약|수소의 둘째번 준위에서 일어나 구속-자유 천이 때문에 365nm에서 생기는 불투명도의 큰 변화로 야기되는 연속 스펙트럼의 큰 변화.
Balmer series|발머계열|수소 원자에서 둘째 번 에너지 준위나 그보다 높은 에너지 준위 사이의 전자 천이를 말한다. 이 천이 때문에 발생한 휘선이나 흡수선은 가시 광선 영역에 있으며, 그 첫 번째 것이 Hα선이다.
barred spiral|막대 나선 은하|나선 은하의 부집단으로 핵을 가로지르는 막대 구조가 있는 나선 은하.
Barycenter|중심, 重心|지구-달 계(Earth-Moon System)의 중력 중심(中心). 지구는 달보다 81배 무겁기 때문에, 중심(重心)은 지구의 구체 내부에 있다.
baryon|바리온|3개의 쿼크(quark)로 이루어진 반(伴) 정수 스핀 입자.
belt|띠|목성형 행성 대기에서 아래로 가라앉는 지역으로 낮은 압력을 보인다.
binarty X-ray sources|쌍 X선원|X선 천체를 포함하는 쌍성계로 X선 천체는 중력으로 수축하는 천체로서 뜨거운 강착 원반에 둘러싸여 X선을 방출한다. 낮은 질량과 높은 질량을 가진 두 종류로 나뉠 수 있는데, 동반별의 질량과 관련이 있다.
binary-accretion model|쌍 집적 모형|달의 기원에 관한 모형으로 달과 지구가 같은 구름의 기체와 티끌에서 각기 집적과정을 거쳐 생겼다는 모형.
binary fields|쌍극장|막대 자석에서 나오는 것과 같은 자기장 배열로 북극과 남극으로 대변된다.
binary galaxies|쌍 은하|중력으로 묶여 있고 공통질량 중심을 도는 두 은하계.
Binary Star|연성, 쌍성|실제로 물리적으로 연결되어 있는 두개의 구성요소(즉, 별들)로 이루어진 별로 그것들의 중력 공통 중심(Common Center Of Gravity) 주위를 돌고 있다. 이것들은 매우 흔한것이다. 몇몇 연성들은 간격이 대단히 작아서 그 성분들이 거의 서로 맞닿아 있으며, 분리하여 볼수는 없지만, 분광학 덕택에 탐지할수는 있다.
bipolar outflow|쌍극분출|젊은 천체에서 두 반대 방향에서 뿜어 나오는 강한 기체 흐름.
Black Hole|블랙 홀, 검은 구멍|매우 무거운 붕괴된 별, 즉 소위 "컬랩서(Collapsar)"라 불리는 것을 둘러싼 우주의 한 지역이며, 그곳에서는 빛조차도 탈출할수 없다.
blue shift|청색 이동|도플러 효과로 접근하는 천체의 복사 파장이 줄어든다. 스펙트럼 선이 짧은 파장(푸른색)으로 이동하는 현상.
Bode's Law|보데의 법칙|태양으로부터 행성의 거리 사이의 경험상의 관계이며, 1772년에 J.D. 티티우스(Titius)에 의해 발견되었고, J.E. 보데(Bode)에 의해 유명해졌다. 이 법칙은 우연히 맞는 것처럼 보이는 것이며, 어떠한 사실상의 과학적인 근거는 없다.
Bolide|폭발 유성|밝은 유성이며, 지구 대기를 통과하여 내려오는 동안 폭발하는 유성.
bolometer|적외선탐지기,저항방사열계|적외선 복사를 감지하는 장치; 수K로 냉각된 반도체에 적외선이 흡수되면 저항이 변하므로 이에 따른 전류의 변화를 측정한다.
Bolometric Magnitude|복사 등급|이것은 단순히 가시광선만이 아닌, 별에 의해 방출되는 모든 복사물질에 의해 결정된다.
bound-free transition|구속-구속 천이|원자나 이온의 두 구속 에너지 준위 사이에서 전자가 일으키는 전자의 천이.
brown dwarf|갈색 왜성|온도가 낮고 광도가 작으며 매우 가벼운 천체(태양 질량의 0.01~0.08 배)이며, 이들은 결코 핵융합 반응을 일으킬 정도로 높은 온도에 이르지 못한다.
Calendar Month |역월|평상시에 사용하는 월
Calendar Year |역년|그레고리력에 의한 한해의 평균길이. 365일 5시간 49분 12초이다.
canali|카날리|이탈리아 말로 "수로" ; 화성의 표면에 나타나는 어두운 직선 모양을 서술하기 위하여 스키아파렐리(Schiaparelli, Giovanni)가 쓴 말이다.
Carbon-Nitrogen Cycle|탄소-질소 순환|항성들은 보통 쓰이는 말처럼 "불타고" 있는 것이 아니다; 항성들은 수소를 헬륨으로 변환시키는 핵융합 반응에 의해 복사물을 방출하고 질량을 잃어버리면서 에너지를 생산하고 있다. 이 변환에서 일어나는 한 방법이 탄소와 질소를 촉매로써 포함하는 연쇄적인 반응에 의한 것이다. 이 과정에 의해 태양이 빛을 내는 것으로 생각되었지만, 현대 모형에서는 태양형 별에서 소위 양성자-양성자 반응(Proton-Proton Reaction)이라 불리는 또다른 순환이 더욱 중요하게 작용하는 것으로 믿어지고 있다. 수소-헬륨 변환과정에 의해 빛을 내지 않는 유일한 항성들은 그들의 진화에서 매우 초기 또는 상대적으로 후기 단계에 있는 것들이다.
Cassegrain Reflector|카세그레인식 반사망원경|관측하는 대상에서 나오는 빛이 주경에서 볼록한 2차경까지 반사되어, 다시 주경에 있는 구멍을 통해 접안렌즈까지 빛이 되돌아가는 반사식 망원경의 한 형식.
cassini's division|카시니 틈|토성 고리에 있는 너비 2000km의 틈. 1675년에 카시니(Cassini)가 발견했으며, 요즘에는 매우 작은 여러 고리를 포함한다고 알려졌다.
catastrophic models|격변 모형|질량이 큰 천체(일반적으로 다른 별과의 충돌)의 영향으로 기체의 집합체가 행성으로 된다는 태양계 기원의 한 모형
causally connected|인과성의|어떤 주어진 사건에 의해 영향을 받을 수 있는 시,공간에서 어떤 사건의 묘사. 어떤 주어진 사건의 광추대에 있는 모든 사건은 그 사건과 관련이 있게 된다.
celestial equator|천구의 적도|지구 적도를 천구에 가상으로 투영시킨 대원. 이 대원의 적위는 0°이다.
celestial pole|천구의 극|지구 극을 천구에 투영시킨 점. 이 점을 중심으로 별들의 일주 운동이 일어난다.
celestial sphere|천구|지구에 중심을 두고 반지름이 큰 가상의 구로 천체들이 그 표면에 고정된 듯이 보인다.
Celestial Sphere|천구, 天球|지구의 중심(中心)과 같은 중심을 가지는, 지구를 둘러 싼 가상적인 구(球). 지구의 축은 천극(天極, Celestial Pole)의 위치를 표시하게 된다; 천구상에 지구의 적도를 투영시킨 것이 천구 적도(Celestial Equator)이다.
Centarus X-3|센타우르스 X-3|센타우르스자리에 있는 무거운 쌍 X선원. 청색 초거성 주위를 도는 가벼운 중성자별(X선원)이 있다.
center of mass|질량 중심|상호 작용을 하거나 연간된 천체의 조합 안에 있는 질량 평형점.
central force|중심력|두 물체의 중심 방향으로 향하는 힘.
centripetal acceleration|구심 가속도|물체가 원궤도의 중심으로 향하는 가속도.
centripetal force|구심력|물체의 직선 운동을 곡선 운동으로 바꾸는 데 필요한 힘으로 곡선의 중심 방향으로 작용한다.
Cepheid, cepheid variables|케페이드 변광성|중요한 변광성의 한 형태이며, 케페이드 변광성은 며칠에서 몇 주 까지의 짧은 주기를 가진다. 그리고 그 행동양식이 매우 규칙적이다. 케페이드 변광성의 주기는 실제 광도와 연관이 있어서, 주기가 길수록 더 밝은 별이라는 것이 발견되었다. 이것으로부터 한 번 케페이드 변광성의 주기가 측정되면 그 거리가 계산될 수 있다. 케페이드 변광성들은 밝은 별들이며, 엄청나게 먼 거리에서도 볼 수 있다; 그것들은 우리은하 내에서 뿐만 아니라, 외부 은하들에서도 발견된다. 케페이드라는 이름은 이러한 종류의 별들 중에서 가장 밝고 유명한 케페우스 자리 델타별(Delta Cephei)의 이름에서 따 온 것이다.
Ceres|세레스|처음으로 발견된 소행성. 1801년 피아치(Piazzi) ,신부가 발견하였다.
Chandrasekher limit|찬드라세카르 한계|백색 왜성의 최대 질량으로 태양 질량의 1.4배 정도이다. 이 질량에서는 축퇴 전자 기체로 된 별의 밀도가 가장 높아지고 반지름이 가장 작아진다. 이보다 무거워지면 별은 중력적으로 붕괴된다.
charge-coupled device, CCD|전하 결합 소자|빛을 흡수하면 전자를 내놓는 반도체로 된 작은 칩으로 되어 있다. 전자는 화소(pixel)라고 하는 작은 부분에 붙잡혀 있다.
charon|카론|명왕성의 위성으로 지름은 대략 1200km이다.
chondrites|콘드라이트|작고 둥근 규산염 입자(콘드률)가 포함된 석질 운석.
chondrules|콘드률|휘발 성분이 부족한 둥근 규산염 입자로 콘드라이트질 운석이나 콘드라이트에서 발견된다. 이들은 원시 태양계 구성 물질이라 여겨진다.
Chromatic Aberration|색수차|모든 렌즈에서 발견되는 결점으로, 소위 위색(False Color)의 발생을 일으킨다. 일례로, 청색광은 적색광보다 더 많이 굴절되어서 렌즈의 더 가까운 곳에 초점이 맺히는 것처럼, 모든 파장의 빛이 똑같게 굴절되는 것이 아니라는 사실 때문에 일어나는 현상이다. 천체 망원경에서는, 대물렌즈가 복합체-즉 여러 종류의 유리로 구성된 렌즈-들로 구성되어있다. 이런 방법으로, 비록 결코 완전하게 보정할 수는 없지만, 색수차를 줄일 수는 있다.
chrompsphere|채층|광구(Photosphere) 바로 위에 있는 태양 대기의 일부분으로 광구보다 뜨거우나 밀도가 낮다; 일식이 일어나는 동안 방출 스펙트럼을 만들어 낸다.
circular velocity|원운동 속도|중력을 가진 물체 주위를 돌며 일정한 원운동을 유지하기 위해 필요한 물체의 속도.
circumpolar stars|주극성|적도 북쪽에 있는 관측자에게 이러한 별들은 계속 북쪽 지평선 위에 나타나며 켤코 남쪽 지평선 밑으로 지지 않는다.
Cluster, Stellar|성단|물리적으로 연결되어 있는 별들의 집단. 산개 성단(Open Cluster)은 수 백개 정도의 별을 포함하며, 일반적으로, 가스나 먼지와 함께 있다; 이러한 성단은 특별한 형태가 없다. 구상성단(Globular Cluster)은 수 천개의 별을 포함하며, 모양이 규칙적이다. 구상성단들은 매우 멀리 떨어져 있으며 은하계의 가장자리 근처에 놓여 있다. 산개성단과 구상성단 둘다 외부은하 내에도 있는 것으로 알려지고 있다. 운동 성단(Moving Cluster)같은 방향으로 같은 속력으로 우주를 가로질러 움직이는 넓게 퍼져 있는 별들로 구성되어 있다. (일례로, 큰곰 자리의 북두칠성중의 5개 별은 같은 운동 성단 내의 구성원 들이다.)
Collimator|시준의, 視準儀|광원으로부터 나오는 빛을 평행한 빛 줄기들로 바꾸어 모으기 위한 광학장치.
collisional excitation|충돌 되가라앉음|충돌을 통해 원자에 있는 전자가 더 높은 에너지 준위로 올라가는 과정.
color excess|색초과|별의 실제 색깔과 관측된 색깔사이의 차이. 보통 시선방향에 있는 성간물질의 효과로 별빛은 실제 색깔보다 붉어진다.
Color Index|색지표|별의 표면온도로부터 나오는 별의 색깔의 측정 정도. 별의 평상등급 즉 안시 등급은 맨눈으로 보이는 겉보기 밝기의 측정값이다; 사진 등급은 사진 감광판 위의 별의 영상의 겉보기 크기를 측정하여 얻어진다. 이 두개의 등급은 일반적으로 같은 것이 아닌데, 왜냐하면 구식의 표준 감광판에서 붉은 별들은 그것이 눈에 보이는 것보다 덜 밝게 보이기 때문이다. 이런한 안시등급과 사진등급의 차이가 색지표로 알려져 있다. 이 척도는 시리우스(Sirius, 큰개자리 Α별)와 흰색 별에 대하여 색지표=0 이 되도록 맞추어져 있다. 푸른색 별은 마이너스 값의 색지표를 가지게 된다; 노란색 또는 적색별은 플러스 값의 색지표를 가지게 된다.
color temperature|색온도|색깔에서 유추한 온도.
Colures|분지경선, 分至經線|천구상의 대원. 일례로 이분경선(二分經線, Equatorial Colure)은 양쪽 천극과 또 춘분점, 즉 황도가 천구 적도와 교차하는 점을 통과하여 지나가는 천구상의 대원(大圓)이다.
Coma1|코마수차|장비내의 광학적인 결점때문에 발생하는, 사진 건판 위의 별의 영상 주위를 둘러싼 흐릿한 아지랑이
Coma2|코마|혜성의 핵을 둘러 싸고 있는 안개 낀 것처럼 보이는 덩어리.
Comet|혜성|태양계의 한 구성원으로, 일반적으로 아주 편심적인 궤도 내에서 태양의 주위를 돌고 있다. 혜성은 희박한 기체와 함께 상대적으로 작은 입자들(주로 얼음)로 구성되어 있다. 혜성의 가장 본질적인 부분은 핵으로, 이 핵은 지름이 수 ㎞정도이다. 혜성의 꼬리는 항상 태양에서 다소 떨어진 곳을 향하게 되는데, 그것은 태양풍의 영향 때문이다. 많은 혜성들이 짧은 주기를 가지고 있으며, 그러한 혜성들은 모두 상대적으로 희미하다. 1세기 미만의 주기를 가진 혜성들중 유일한 밝은 혜성은 헬리 혜성이다. 가장 밝은 혜성들은 주기가 너무 길어서 그들의 회귀를 예측할 수 없을 정도의 긴 주기를 가진다.
compact radio galaxies|밀집 전파 은하|중심 부분에 작고 강한 전파원을 갖고 있는 활동 은하.
condensation|응결|원자나 분자들이 결합하여 이루어지는 고체 입자의 생성 현상.
conduction|전도|입자들의 충돌로 에너지를 전달하는 방식.
Conjunction|합, 合|한 행성의 별이나 다른 천체로의 겉보기 접근 현상; 이것은 순전히 조준선(Line-Of-Sight) 효과이며, 왜냐하면 행성들은 별보다 훨씬 우리에게 가깝기 때문이다. 내합(內合)은-수성과 금성에서만 있다.-행성이 태양과 같은 적경을 가질 때의 위치이다. 외합(外合)은 지구에 대해서 태양의 반대편에 있을 때의 행성의 위치이다.
conservation of energy|에너지 보존|물리학의 기본 원칙으로 고립된 계에서는 내부의 어떠한 변화가 있더라도 전체 에너지는 일정하다는 원칙.
conservation of magnetic flux|자력선속 보존|어떠한 환경에서 한 면적을 통과하는 자기력선의 수는 일정하다는 물리적 원칙.
conservation of momentum|운동량 보존|순 힘이 없다면 고립된 계에서 총 운동량은 언제나 일정하다는 물리적 원칙.
Constellation|별자리|실존 인물이나 신화의 인물 또는 무생물들의 이름을 따서 명명된 별들의 무리, 그리고 그 별 무리로 인해 차지하고 있는 영역을 나타낸다. 그 이름들은 매우 상상적이며, 어떠한 실제로의 중요성은 없다. 별자리들은 또한 서로 물리적으로 연결된 별들로 구성되어 있는 것도 아니다; 각각의 별들은 지구에서 매우 다른 거리에 놓여 있으며, 단지 우주 내에서 대충 같은 방향에 우연히 있게 된 것이다. 국제 천문 연합(IAU, International Astronomical Union)은 현재 88개의 별자리들을 인정하고 있다.(역시나 천문학을 전공하시는 분들은 별자리의 신화나 점성적인 재미에 대해서는 많이 싫어하시는 듯합니다. -_-;)
continuous spectrum|연속 스펙트럼|흡수선이나 방출선으로 일그러지지 않고 모든 파장에서 방출함을 보여주는 스펙트럼.
contour map|등세기선 지도|몇 가지 종류의 복사 세기가 하늘 전체에 걸쳐 얼마나 변했는지를 보여주는 그림. 그림에 나오는 선은 같은 세기인 점을 이은 것이다. 가깝게 놓은 선들은 작은 거리에서 세기 변화가 급격하게 이루어짐을 뜻하고, 넓게 떨어져 있는 선들은 그보다는 천천히 변화함을 뜻한다.
convection|대류|유체의 흐름에 의한 에너지 전달 방식.
core of the Earth|지구의 핵|지구의 중심 부분으로 매우 높은 밀도를 가지고 있으며, 부분적으로는 액체 상태이고 철이나 철 합금으로 이루어졌을 것이다.
core of the Galaxy|우리 은하의 핵|은하 중심부의 수파섹(pc) 내부 영역으로 작은 비열적인 전파원과 빠르게 움직이는 이온 기체 구름이 포함되어 있다.
corona|코로나|태양 대기의 가장 바깥 부분으로 희박한 이온화 기체로 되어있으며 온도가 106K이다. 개기일식 동안에만 맨눈으로 관찰 가능.
Coronagraph(코로나 그래프, 광관의|光冠儀)|일반적인 상태에서도 태양의 코로나를 보기 위하여 설계된 망원경의 한 형식. 일반적인 망원경으로는 이러한 일을 하는 것이 불가능 한데, 왜냐하면 지구 대기에 의해 태양빛이 하늘을 지나면서 흩어지기 때문이며, 한편으로는 망원경 내에서 흩어지는 빛 때문이다. 코로나 그래프는 프랑스의 천문학자인 B.Lyot에 의해 발명되었다.
coronal hole|코로나 구멍|태양 코로나에서 고온 플라즈마가 적은 지역. 여기에서 자력선이 행성간 공간으로 뻗어 나가며, 태양풍의 근원이 된다.
coronal interstellar gas|코로나 성간 기체|X선 방출을 통해 나타나는 고온의 성간 플라즈마.
Cosmic Background Explorer, COBE|우주 배경 복사 관측 위성|1989년 발사되어 마이크로파 배경 복사의 스펙트럼과 그 세기를 측정하기 위한 관측 위성.
cosmic blackbody background radiation|우주 흑체 배경 복사|우주 전체에 널려있는 2.7K 흑체 복사. 우주가 생길 때 있었던 원시 화구의 자취로 여겨진다.
cosmic nucleosynthesis|우주 핵합성|"대폭발"에서 초기 100초 동안 이루어지는 가장 가벼운 핵의 행성 과정.
cosmic rays|우주선|에너지가 매우 큰(거의 빛의 속도로 달림), 우주 공간을 움직이는 대전된 원자 입자. 대부분은 태양계 밖에서 생기지만, 낮은 에너지를 가진 몇몇은 태양 플레어에서 생긴다.
cosmic void|우주 빈터|은하가 관측되지 않는 공간의 커다란 빈 영역.
cosmological principle|우주론적 원칙|큰 부피를 전부 평균하여 우주의 어떤 곳에 있어도 우주는 같게 보인다는 원리.
cosmology|우주론|물리적 우주의 세계와 진화를 다루는 학문.
cosmos|(조화) 우주|질서 있고 조화로운 체계로 표현되는 우주.
Counterglow|대일조, 對日照|게이건샤인(Gegenschein) 참조
Crab nebula|게 성운|황소자리에 있는 초신성 잔해로 1054년에 관측된 초신성에서 생겼다. 이 성운 안에 있는 펄서는 폭발한 별의 잔해로 보인다.
crater|구덩이|보통 고체의 충돌이나 표면 분출로 둥글게 생긴 움푹한 땅.
crater terrain|구덩이 지형|구덩이가 많이 있는 광경으로 오래 되고 거의 진화하지 않은 지형.
crescent|초승/그믐|달이나 행성의 위상으로 보이는 면이 절반을 넘지 않을 경우를 말한다.
critical density|임계 밀도|우주론에서 말하는 열린 우주에서 닫힌 우주로 넘어가는 밀도의 경계 값. 이 밀도는 무한히 팽창하는 것을 막을 만큼 중력이 나타나게 한다.
crust|지각|행성에서 가장 얇고 바깥쪽에 있는 표면층. 지구에서는 현무암질과 화강암질로 되어 있다.
C-type asteroids|C형 소행성|낮은 반사도를 보이는 소행성으로 상당량의 탄소가 있을 가능성이 높다.
Culmination|자오선 통과, 남중|별이나 다른 천체가 관측자의 자오선(Meridian)에 도달할 때의 시간으로 그것의 가장 높은 위치에 있게 된다(상층 자오선 통과). 만약에 그 천체가 극에 가까울 때에는 12시간 후에 한 번 더 자오선을 가로지르는 것을 관측할 수 있을 것이다(하층 자오선 통과). 극에서 멀리 있는 천체들에서는 하층자오선 통과는 지평선 아래에서 일어나기 때문에 관측될 수가 없다.
cyclone|사이클론|행성의 자전 때문에 행성 대기에 나타나는 유체의 나선 흐름.
dark cloud|암흑 구름|(지구에서 볼 때) 뒤에 있는 별빛을 거의 완전히 막을 만큼 티끌이 충분히 들어있는 성간 구름.
dark matter|암흑 물질|우주에 있는 물질들이 많이 가질 것으로 보이는 형태. 중입자가 아닌 입자이며, 별이나 은하를 이루지 않는다. 따라서 "암흑"이라고 부른다.
Day|하루, 일주야|일상적으로 사용하는 말로, 하루는 지구가 자신의 축을 중심으로 한바퀴 회전하는데 걸리는 시간의 총 합이다. 항성일(Sidereal Day)은 별을 기준으로 측정된 지구의 자전주기이다(23시간 56분 4.091초). 태양일(Solar Day)은 정오와 정오(즉 태양이 남중하는 시간)사이의 간격이다(평균 태양일은 24시간 3분 56.555초이다.). 태양일은 항성일보다 더 긴데, 이것은 태양이 황도(Ecliptic)을 따라 동쪽으로 움직이기 때문이다. 역일(曆日, Civil Day)는 물론 24시간이다.
Declination|적위|천구 적도의 남북쪽에 있는 천체까지의 각거리. 이것은 지구 표면 위의 위도에 해당한다고 할 수 있다.
decoupling era|단절 시대|물질과 광자가 상호작용을 단절할 정도로 밀도가 낮아진 우주 역사의 어떤 시점.
deferent|이심원|행성의 겉보기 동진 운동을 설명하기 위해 쓴 고대 기하하적 수단; 지구에 중심을 둔 큰 원이 행성의 주전원을 달고 있다.
degenerate electron gas|축퇴 전자 기체|원자핵과 전자가 가능한 한 꽉 묶인 이온화된 기체이며, 모든 가능한 낮은 에너지 상태가 모두 채워져 있기 때문에 압력, 온도 밀도에 관한 완전 기체의 법칙이 적용되지 않는다.
degenerate gas pressure|축퇴 기체압|밀도가 매우 높게 응축된 축퇴 기체가 미치는 압력으로, 밀도에만 관련되고 온도와는 별 관련이 없다.
degenerate neutron gas|축퇴 중성자 기체|가능한 한 꽉 묶인 중성자로 이루어진 물질.
Deimos|데이모스|화성에 잇는 두 개의 달 중 작은 것으로 어둡고 구덩이가 패인 표면이 있다.
density-wave model|밀도파 모형|은하 나선구조에 관한 모형으로 성간 구름을 쓸고 지나면서 별 생성을 촉진시키는 밀도파(음하와 비슷한)을 묘사한다.
Dichotomy|현월상, 弦月相|수성, 금성, 또는 달의 정확히 절반의 위상(Phase)
differential rotation|차등 회전|유체로 된 구형의 물체가 극에서보다 적도에서 더 빨리 도는 경향을 말한다.
Diffraction Rings|회절고리|망원경 내에서 볼 수 있는 별의 상 주위를 둘러싸고 있는 동심원형의 고리들. 이것들은 없어지지 않는데, 왜냐하면 이것들은 빛의 파동에 의해 생겨나기 때문이다. 이것들은 작은 기기에서 가장 분명하게 나타난다.
diffuse nebula|발광 성운|이온화한 기체구름으로 대부분 수소로 이루어졌으며, 방출선 스펙트럼을 띤다.
Direction Motion|순행, 順行|지구와 같은 방향으로 태양의 주위를 도는 천체를 순행한다고 한다. 이러한 것들이 반대로 움직일 때는 역행(Retrograde Motion)한다고 한다. 이 용어는 행성의 위성들에도 또한 적용될 수 있다. 어떤 행성이나 소행성도 역행하는 것은 알려져 있지 않지만, 많은 역행 위성이나 혜성들은 있다. 또 이 용어들은 하늘에서의 행성의 겉보기 운동에 관하여서 사용된다. 항성들을 배경으로 동쪽으로 움직인다면 순행하는 것이다. 서쪽으로 움직인다면 역행하는 것이다.
dirty-snowball comet model|더러운 눈덩이 혜성 모형|혜성에 관한 모형으로 물질이 암석편과 함께 섞여 얼어 있는 고체로 된 핵을 묘사한다. 혜성이 태양에 가까워지면 더러운 얼음 덩어리가 증발하여 머리와 꼬리를 만들면서 기체를 낸다.
disk of a galaxy|은하 원반 |은하핵 바깥에 위치한 별, 기체, 티끌의 평평한 모양.
Diurnal Motion|일주운동, 日周運動|동쪽에서 서쪽으로 움직이는 하늘의 하루동안의 겉보기 회전. 이것은 서쪽에서 동쪽으로 지구가 자전하기 때문에 일어난다.
D-line|D선|나트륨 때문에 노란색 영역에서 나타나는 한 쌍의 어두운 선 스펙트럼.
Doppler Effect|도플러 효과|관측자의 운동에 의해 발생하는 빛의 파장의 겉보기 변화. 빛을 방출하는 천체가 지구로 접근할 때, 그 천체가 정지되어 있는 경우보다 더 많은 광파가 1초당 관측자의 눈에 들어오게 된다. 그래서, 겉보기 파장은 짧아지게 되며 빛은 "청색으로 치우친" 것처럼 보인다. 만약 천체가 멀어지고 있다면, 파장은 외관상으로 길어지게 되며 빛은 "적색으로 치우치게" 된다. 평상의 속도에서 색 변화는 매우 미미하지만, 이 효과에서 물체의 스펙트럼이 관계되어 있음을 나타내고 있다. 만약 검은 선들(프라운호퍼 선 같은 것들)이 적색 즉 장파장 쪽으로 이동되었다면, 그 천체는 분명히 멀어지고 있는 것이다. 그리고 이런 치우침(편이)의 총 량이 후퇴속도의 열쇠가 된다. 우리의 국부은하군(Local Group)내의 몇몇 은하들을 제외하고, 모든 외부 은하들은 적색 편이를 보이고 있으며, 이것은 우주가 팽창한다는 관측적인 증거이다. 도플러 효과는 전파나 복사에 있어서도 적용시킬 수 있다.
Doppler shift|도플러 이동|시선 방향으로 관측자나 전파원이 움직일 때 나타나는 파장의 변화. 운동아 관측자에게 접근하면 파장이 줄어들고(청색이동), 멀어지면 파장이 늘어난다(적색이동).
double quasars|이중 퀘이사|중력 렌즈 효과로 한 퀘이사가 두 상(像)으로 나타난 것.
Double Star|이중성|두 개의 동반성으로 이루어져 있는 별. 몇몇 이중성은 광학적이다. 바꿔 말하자면, 동반성들이 물리적으로 연결된 것이 아닌, 단지 지구에서 봤을 때, 우연히 같은 방향에 놓여 있는 것이다. 대부분의 이중성들은, 여하간에, 물리적으로 연결되어있는 연성계(Binary System)이다
dwarf|왜성|상대적으로 광도가 낮고 크기가 작은 별. 광도 계급이 V인 주계열별.
dynamo model|다이너모 모형|행성(또는 별)의 자기장 생성 모형으로, 이 모형에 따르면 핵 내부에 있는 전도성 유체의 조직적 운동으로 자기장이 생기게 된다.
Earthshine|지구조, 地球照|달의 밤 부분에서 보이는 희미한 발광현상으로, 지구에서 나온 빛(즉 지구에 의해 반사된 태양빛)이 달에 반사 되어서 생기는 현상이다.
eccentricity|이심률|타원 중심에서 초점까지 떨어진 거리의 타원 긴 반지름에 대한 비율.
eclipse|식|한 천체가 다른 천체 앞을 지나가면서 빛을 가로막는 현상.
Eclipsing Binary, Eclipsing Variable|식 연성, 식 변광성|지구에서 볼 때 구성 별들이 서로간에 함께 식을 일으키는 각도를 가진, 중력 공통 중심을 돌고 있는 두개의 동반성으로 이루어진 연성. 식 연성인 알골(Algol)의 경우에는 한 별이 나머지 한 별보다 훨씬 더 밝다. 그래서 매 이틀마다 희미한 별이 밝은 별을 가려서 알골이 한등급 이상 광도가 어두워지게 되는 것처럼 보인다.
eclipsing binary system|식 쌍성계|공통 질량 중심을 공전하는 두 별의 궤도면이 시선 방향에 놓여 있어 주기적으로 한 별이 다른 별을 가리게 되는 쌍성계.
Ecliptic|황도|천구 상에 지구 궤도를 투영한 것. 이것은 또한 황도대(Zodiac)의 별자리들을 통과하는, "별들에 대한 태양의 1년간의 겉보기 경로"라고 정의될 수 있다. 지구 궤도면이 적도에 대해 23.5도 만큼 기울어져 있으므로 황도와 천구 적도간의 각도 역시 23.5도이다.
Ecosphere|생물 생존권|적당한 조건 아래에 생명체가 존재할 수 있도록 온도가 너무 뜨겁거나 차갑지 않은 항성 주위의 영역. 금성은 생물 생존권의 안쪽 가장자리 근처에 있다. 반면에 화성은 바깥쪽 가장자리 근처에 있다. 다른 항성의 생물 생존권은 그 항성의 광도와 관계가 있는 것으로 생각되고 있다.
Eddington luminosity|에딩턴 광도|중력을 이기고 물질을 밀어낼 만한 광도.
Eddington mass|에딩턴 질량|주어진 광도에서 복사압을 극복할 만큼의 중력에 해당하는 질량.
effective temperature|유효 온도|같은 광도와 크기를 나타내는 흑체가 가지는 온도.
Einstein Observatory|아인슈타인 관측 위성|HEAO-B라고도 하며 천체의 X선 영상을 찍는다.
electromagnetic force|전자기력|자연에 있는 네 가지 힘중 하나로, 전자기적 전하를 띠는 입자가 전하가 같고 다름에 따라 밀거나 끌어당기는 힘.
electromagnetic radiation|전자기 복사|스스로 퍼져 나가는 전기파나 자기파로 빛이나 전파, 자외선, 적외선 복사 등을 예로 들 수 있다. 모든 형태의 전자기파는 같은 속도를 가지며, 파장이나 주파수로 나눌 수 있다.
Electromagnetic Spectrum|전자기파 스펙트럼|전자기 복사(Electromagnetic Radiation)라고 불리는 것의 모든 범위. Γ선, X선, 자외선 복사, 가시광선, 적외선 복사 그리고 전파까지의 범위라고 할 수 있다. 가시광선은 모든 전자기파 스펙트럼 중 단지 매우 작은 부분을 이루고 있다. 그리고 모든 복사선들 중에 단지 가시광선과 전파 일부만이 지구 대기를 통과하여 지표면에 도달한다.
electron|전자|가볍고 음전하를 띠는 아(亞)원자 입자.
element|원소|같은 화학적 성질을 갖지만 화학적으로 더 이상 간단한 것으로 나눠지지 않는 원자로 이루어진 물질.
Elongation|이각|태양에서 행성까지의, 또는 주행성에서 그 위성까지의 겉보기 상의 각 거리
Emission Spectrum|방출 스펙트럼|밝은 선이나 띠로 구성되어 있는 스펙트럼. 낮은 밀도를 가진 백열광을 내는 기체들이 방출 스펙트럼들을 형성한다.
energy|에너지|일을 할 수 있는 능력.
energy level|에너지 준위|원자의 가능한 양자 상태 중 하나로, 이 상태에서 대응되는 에너지 값이 있다.
Ephemeris|역서,천체력天體曆|다양한 시간동안 천체의 위치를 보여주는 표. 행성이나 혜성같은, 한 움직이는 물체의 예언된 위치를 표시하고 있는 표.
epicycle|주전원|행성의 겉보기 운동을 설명하기 위해 프톨레미와 같은 고대 천문학자들이 이용한, 이심원(deferent)에 중심을 둔 조그만 원.
Epoch|시대, 대|참고를 위하여 선택된 기간이며, 천문학적 정보를 나타내기 위한 용도로 쓰인다. 예를 들면, 몇몇 별 목록들은 "Epoch 1950"에 맞추어져 있다. 2000년 까지 그 정해진 위치들은 세차운동(Precession)의 영향 때문에 미미하게 바뀌게 될 것이다.
equant|사분의|행성 운동의 변화를 설명하기 위해 프톨레미가 고안한 고대의 기하학적 측정기구.
Equation Mount|적도의식 가대|지구의 축과 평행한 축 위에 설치되는 망원경의 가대 형식; 축의 각도는 관측자의 위도와 반드시 같다. 이것은 망원경이 적도의 식으로 설치되면, 시야내에 대상을 유지할 수 있음을 뜻하지만, 최신 컴퓨터들의 도움으로 경위의식 가대가 적도의식 가대만큼 유용하게 사용할 수 있게 되었다.
equation of state|상태 방정식|기체의 압력, 온도, 밀도를 서술하는 식.
Equation Of Time|균시차, 均時差|지구의 궤도가 원이 아니기 때문에, 태양은 별들 사이를 일정한 비율로 움직이지 않는다. 그래서 천문학자들은 평균 태양(Mean Sun)을 사용하는데, 이 평균 태양은 실제 태양의 평균 속도와 같은 속도로 별 사이를 운행한다. 실제 태양이 평균 태양 앞이나 뒤에 있는 간격의 정도가 균시차라 불리는 것이다. 이것은 17분을 초과하지 않는다. 매년 4회 균시차는 0이 된다.
equator bulge|적도 팽대부|지구 적도 반지름이 극반지름보다 초과된 값으로 대략 43km이다.
Equinox|분점, 分點|1년에 두 번 태양은 천구 적도를 교차하는데, 한 번은 남쪽에서 북쪽으로 이동할 때(3월 21경) 이며, 한 번은 북쪽에서 남쪽으로 이동할 때(9월 22일경)이다. 이 점들은 각각 춘분점(Vernal Equinox, First Point Of Aries)와 추분점(Autumnal Equinox, First Point Of Libra)으로 알려져 있다. (즉 분점들은 황도가 천구 적도를 가로지르는 두 점들이다.)
Escape Velocity|탈출속도|별도의 추진력이 주어지지 않은 상태에서 어떤 공기저항도 간과하지 않을 경우, 행성이나 다른 천체의 표면에서 탈출을 하기 위한 최소한의 속도. 지구의 탈출 속도는 11㎞/S, 즉 대략 40200㎞/H 이다. 달에서는 겨우 2.4㎞/S이다. 목성에서는 60㎞/S만큼이나 한다.
Euclidian flat  geometry|유클리드 평면 기하학 |한 점에서 어떤 직선과 평행한 직선은 오직 하나밖에 그을 수 없다는 기하학, 평면에서 삼각형의 내각의 합은 180° 이다.
evolutionary track|진하 경로|온도-광도 관계도(H-R도)에서 별이 시간에 다라 변하는 모습을 나타낸 경로.
excitation|들뜸|원자의 에너지 상태가 더 높은 준위로 올라가는 과정.
exosphere|외기권|행성 대기의 가장 윗부분으로 이곳으로부터 대기 입자가 우주 공간으로 탈출하게 된다.
exponential decay|지수함수적 붕괴|방사능 붕괴와 같이 어떤 양의 변화가 시간에 대하여 지수함수적으로 변하는 붕괴 과정.
extinction|소광|빛이 지구 대기나 성간 물질 등 어떠한 물질을 통과할 때 그 세기가 줄어드는 현상.
eyepiece|접안 렌즈|망원경의 주 렌즈에 의하여 생긴 상을 보기 위한 확대 렌즈.
Faculae|백반, 白斑|태양표면 위의 밝고 일시적인 반점으로, 일반적으로 (비록 항상 이런 것은 아니지만) 흑점(Sunspot)과 연관되어 있다. 백반들은 종종 흑점군이 막 생기려는 장소 근처에서 나타나며, 사라져 버린 흑점군의 장소에서 얼마동안 남아있기도 한다.
first dredge-up|첫번째 준설(끌어올림)|적색 거성이 된 다음 처음으로 수소 연소물을 표면까지 끌어올리는 현상.
First Point Of Aries|양자리의 제일점|춘분점(Vernal Equinox). 춘분점의 적경은 0의 값을 가지게 되면, 모든 천체들의 적경은 이것에 의해 조절되어진다. 분점(Equinox)를 볼것
first quarter|상현|달이 삭에서 궤도를 1/4만큼 움직인 다음 나타나는 위상. 지구에서 볼 때 절반이 보인다.
Flares, Solar|태양면 폭발 플레어|태양 대기의 바깥쪽 부분에서의 밝은 분출현상으로 일반적으로 활동적인 흑점군과 관계가 있다. 이들은 나중에 지구에 도달하기도 하는 대전된 입자들을 방출하여 자기 폭풍과 극광(Aurora) 들을 발생시킨다. 그들은 또한 태양 전파 방출의 강력한 폭발과도 연결되어 있다. 플레어에서 방출되는 입자들이 우주공간이나 무방비 상태의 달 표면에 있는 우주비행사들에게 위험을 줄 수 있다는 사실이 주장되어왔다.
Flare Stars|섬광성, 閃光星|수 분 동안 몇 등급 정도 밝아지는 희미한 적색왜성으로, 약 1시간 이내에 그들의 평상시 밝기로 희미해져 간다. 이러한 현상은 별의 대기내에 있는 격렬한 플레어 활동에 의한 것이 틀림없다고 생각되고 있다. 비록 거기에 필요한 에너지가 태양의 플레어에 필요한 것 보다 훨씬 더 높지만, 태양 면의 플레어의 경우처럼, 모든 별의 대기가 관련되는지 또는 단지 작은 지역에서 일어나는 것인지는 아직 알려져 있지 않다. 대표적인 섬광성은 고래자리 UV별(UV Ceti)와 사자자리 AD별(AD Leonis)이다.
flash spectrum|섬광 스펙트럼|개기 일식이 일어나기 바로 직전에 나타나는 스펙트럼으로 정상 흡수 스펙트럼이 채층의 방출 스펙트럼으로 바뀐다.
flocculent galaxies|양털 모양 은하|잘 나타난 나선팔보다 부푼 구조가 원반에 나타나는 나선 은하.
Flocculi|양모반, 羊毛斑|태양 표면 위의 반점들로, 분광기(Spectroscope)의 원리에 의거한 기구에 의해 관측된다. 밝은 양모반들은 칼슘으로 이루어진 것들이다. 어두운 양모반들은 수소로 구성되어 있다.
focal length|초점 거리|멀리 있는 물체에서 나온 빛이 모인 점이 렌즈(또는 거울)에서 떨어진 거리.
focus|초점|망원경에서 빛이 모이는 점.
forbidden line|금지선|확률이 매우 낮은 천이를 통해 일어나는 방출선.
Fraunhofer Lines|프라운호퍼 선|태양 스펙트럼 내의 검은 흡수선들. 이것들은 1814년에 최초로 그 선들을 연구하고 천체도로 작성한 독일의 광학자인 J. Von Fraunhofer를 기념하기 위해 이름 지어졌다.
free-bound transition|자유-구속 천이|전자가 자유 에너지 상태에 있다가 원자에 구속되는 상태로의 천이. 원자에서 볼 때는 광자 방출을 하면서 전자를 얻는 결과를 보인다. 반대는 구속-자유 천이
free-fall|자유 낙하|입자 사이의 충돌로 생기는, 압력 방해가 없는 조건에서 일어나는 중력 붕괴.
free-free transition|자유-자유 천이|다른 두 자유 상태에서 일어나는 전자의 천이. 전자가 에너지를 잃으면 자유-자유 방출이 나타나며, 에너지를 얻으면 자우-자유 흡수이다.
frequency|진동수|일정한 기간 동안(보통 1초) 특정한 지점을 통과하는 파의 수. 단위로는 보통 Hz(1초당 1주기)를 쓴다.
Fringe Region|프린지 구역|외기권(Exosphere)의 위쪽 부분. 프린지 구역 내의 원자 입자들은 서로 충돌할 기회를 거의 가지지 않으며, 사실상 지구 중력에 지배를 받는, 자유궤도 내에서 움직인다.
full moon|만월(보름)|달이 태양 반대편에 있을 때 나타나는 위상. 지구에서 볼 때 꽉 차게 빛난다.
galactic cannibalism|은하의 양육강식|더 무거운 은하가 조석력으로 더 가벼운 은하의 물질을 잡아채는 은하의 상호 작용 모형.
galactic center core|은하핵|은하의 중심 부분에 가장 안쪽에 있는 것.
galactic equator|은하 적도|은하수를 따라 만든 대원. 은하 중심의 평면을 나타낸다.
galactic latitude|은하 위도|은하 적도에서 남쪽이나 북쪽으로 떨어진 각거리.
galactic longitude|은하 경도|은하 중심에 영점을 잡고 은하 적도를 따라 잰 각거리.
galactic open cluster|은하(산개) 성단|수십에서 수백 개 정도되는 종족 Ⅰ별이 중력적으로 묶인 작은 집단. 은하 평면 안이나 근처에서 발견된다.
galactic rotation curve|은하 회전 곡선|은하 중심에서 어느 정도 떨어진 천체가 은하 주위를 얼마나 빨리 도는가를 나타내는 곡선.
Galaxies|은하, 銀河|별들의 조직계; 우리 은하는 대략 1000억개의 별을 포함하지만, 크기에서 특별한 것은 아니다. 은하들은 다양한 모습들을 가지고 있다. 일부는 나선형이며, 일부는 타원형, 일부는 불규칙하다. 가장 멀리 있다고 알려진 은하는 적어도 180억 광년 저쪽에 있다; 우리의 국부 은하군(Local Group)의 은하들을 제외한, 모든 은하들이 우리에게서 멀어지고 있으므로 전체 우주는 팽창하고 있는 것이 된다.
galaxy|은하|매우 많은 별들(106~1012)과 기체, 티끌의 모임으로 이들은 중력으로 묶여 있다. 우리 은하 안에 태양이 있다.
Galilean moons|갈릴레오 위성|갈릴레오가 망원경으로 발견한 목성의 4대 위성 (이오, 에우로파, 가니메데, 칼리스토)
gamma ray|감마선|X 선보다 파장이 짧고 에너지가 높은 광자.
gas tail|기체 꼬리|혜성 꼬리의 일부로 이온과 분자로 이루어짐. 태양풍의 작용으로 생긴다. 태양의 복사압으로 밀려나가 생기는 티끌과 꼬리로 구별된다.
Gauss: G|가우스|자기장의 세기를 나타내는 물리적 단위. SI단위로는 테슬라(Tesla)이지만 천문학자들은 가우스를 더 많이 쓴다. (104가우스=1테슬라)
Gegenshein(게이건샤인, 대일조|對日照)|정확히 태양의 반대쪽의 하늘에서 보이는 희미한 빛줄기. 이것은 관측하기가 매우 어렵고, 만족스럽게 찍힌 적이 절대 없었다. 이것은 태양계의 중심평면을 따라 퍼져 있는 희박한 물질에 의해 발생하며, 그래서 황도광(Zodiacal Light)와 연관이 있다.
general theory of relation|일반 상대성 이론|아인슈타인이 발전시킨 생각으로 질량과 에너지가 시공간 기하학을 결정하기 때문에 시공간의 곡률은 우리가 흔히 중력이라 부르는 것으로 드러난다고 한다. 아인슈타인 중력 법칙.
Geocorona|중간권, 中間圈|대기의 가장 윗 부분 경계 근처에서 지구를 둘러싸는 매우 희박한 수소의 층.
Geodesy|측지학|지구의 형성, 용적, 탄생, 질량, 중력, 관련 법칙등에 대해 다루는 과학
geomagnetic axis|지자기축|지구의 자극을 연결한 축. 지구 자전축과 12° 기울어져 있으며 지구 중심을 통과하지 않는다.
Geophysics|지구 물리학|지구의 물리적 특성과 그 환경에 대한 것을 다루는 과학. 그 범위는 지구의 내부에서부터 자기권의 경계 부분까지 미친다. 1957~1958년에는 야심적인 국제 계획인, 국제 지구 관측년 (International Geophysics Year)이 만들어 지면서, 태양 흑점의 극대기 일때 지구 물리학적 현상의 집중적인 연구가 착수 되었었다. 이것은 18개월동안 계속되었고, 너무나 성공적이여서, 다음 흑점 극소기일때 더 제한적이었지만, 여전히 광대한 계획이 만들어 졌는데, 그것이 정적 태양의 국제 관측년(Ineternational Year Of Quiet Sun)이다.
giant impact model|거대 충돌 모형|달의 기원에 관한 시나리오로 화성 크기의 천체가 갓 생겨난 지구와 부딪쳐 순간적인 흐름이 생기고 충돌한 천체와 지구에서 나온 물질이 지구 주위에 원반을 이루고 결국은 달로 성장한다는 모형.
giant molecular cloud|거대 분자 구름|큰 성간 구름으로 크기는 수십 pc이고 10만 태양 질량 정도의 질량을 가지고 있다. 은하 나선팔이 있으며, 무거운 별이 생기는 곳이다.
Gibbous(볼록상, 철월|凸月)상|절반보다는 많지만 보름보다는 적을 때의 달이나 행성의 위상
globular cluster|구상 성단|105~106개 정도 되는 종족 Ⅱ별(대략 태양질량인)이 중력으로 묶인 집단. 구대칭적으로 생겼으며, 우리 은하 헤일로를 구성한다.
gluon|글루온|강한 핵력을 전달하는 보손(boson)
grand design spirals|대규모 디자인 나선 은하|나선팔 구조가 잘 발달한 나선 은하.
Grand Unification Theories ,GUTs|대통일장 이론|우주 진화에서 우주의 기원을 "대폭발"이라고 하는 뜨겁고 밀도가 높은 상태에서 갑작스럽게 팽창해서 차갑고 밀도가 낮은 상태로 되었다고 서술하는 모형.
granule|쌀알조직|태양 광구에서 개략적인 조직으로 나타나는 수명이 짧은(3~10분) 밝은 점.
gravitation|만유 인력|뉴턴의 정의에서 질량 덩어리 사이에 미치는 힘은 서로 접근하는 방향의 가속도로 특징지을 수 있다. 그 힘의 크기는 질량의 곱과 그들 사이 중심 거리의 역제곱에 비례한다. 아인슈타인의 정의에서는 시공간의 곡률이다.
gravitational bending of light|중력으로 빛이 구부러짐|일반적으로 광자가 곧게 지나가는 길에 미치는 중력 효과.
gravitational field|중력장|물체들 사이에 중력을 미칠 수 있는 공간 잠재력; 자유 질점의 가속도로 표현된다.
gravitational focusing|중력 초점 모임|큰 물체 주위를 작은 물체가 지나갈 때 그 지나가는 길의 방향이 변화하여 교차하게 되는 현상.
gravitational force|중력|자연에 있는 네 가지 힘 중에서 가장 약한 힘. 0보다 큰 질량을 가진 모든 입자는 서로 끌어당김.
gravitational instability|중력 불안정|중력 붕괴를 당하는 지역의 기체가 교란(섭동)을 받는 현상.
gravitational lens|중력 렌즈|무거운 질량 때문에 빛이 구부러져서 전파원의 상을 만드는 효과.
gravitational mass|중력 질량|다른 물체의 중력으로 결정되는 어떤 물체의 질량.
gravitational potential energy|중력 위치 에너지|중력장 안에서 천체의 위치와 관련된 구속 에너지.
gravitational redshift|중력 적색 이동|중력 때문에 광자의 파장이 길어지는 변화. 이는 중력장이 강한 곳에서 약한 곳으로 움직이는 광자가 에너지를 잃음을 뜻한다.
great circle|대원|구에 있는 두 점을 가장 가깝게 이은 선을 연장하여 그은 구면상의 원.
Great red spot|대적점|목성에 잇는 크고 지속적이며 높은 압력을 띤 폭풍 소용돌이.
Green Flash|녹색 섬광 현상, 그린 플래쉬|태양이 질 때, 그 원반의 마지막에 보이는 부분이 매우 짧은 기간동안 밝은 녹색으로 번쩍거리기도 한다. 이것은 지구 대기의 영향때문에 생기는 것으로 수평선 위에서 가장 잘 관측된다. 금성 또한 질 때에 그린 플래쉬를 보이는 것으로 알려져 있다.
greenhouse effect|온실 효과|적외선 영역에서 대기의 불투명도 때문에 열복사가 갇히게 되어 행성 표면의 평형 온도가 높아지는 효과.
Greenwich Meridian|그리니치 자오선|그리니치 천문대에 있는 에어리 자오환(環)(Airy Transit Circle)을 통과하는 경도선. 이것은 경도 0˚의 값을 가지며, 전 세계에 걸쳐 기준으로 사용되고 있다.
Gregorian Reflector|그레고리안식 반사망원경|반사식 망원경의 한 형태로 그 망원경 안으로 들어온 빛은 주경에서 주경의 초점 밖에 위치한 작은 오목거울로 반사된다. 그 후 빛은 되반사 되어 주경에 있는 구멍을 통과하고, 초점을 이룬다. 그레고리식 반사망원경들은 지금은 잘 사용되지 않는다.
ground state|바닥상태|원자의 가장 낮은 에너지 준위.
Halation Ring|헐레이션 고리|사진상의 별의 영상 주위에 때때로 보이는 고리. 이것은 순전히 사진 기술에 의한 효과이다.
half-life|반감기|표본인 방사성 원소가 반으로 줄어드는데 걸리는 시간.
Halo|헤일로|① 태양이나 달 주위의 밝은 고리로, 지구의 상층 대기 속에 있는 얼음 결정에 의해 발생한다. ② 은하 헤일로(Galactic Halo)의 약어: 우리 은하의 중심 부분 주위의 구체모양의 별들이 모여 있는 부분.
halo of a galaxy|은하의 헤일로|은하 주위의 구형 영역으로 원반이나 핵을 포함하지 않고 구상 성단 기체, 그리고 몇 개의 미아 별을 포함한다.
H-alpha line|수소-알파선|수소 원자의 둘째번 에너지 준위와 그보다 높은 에너지 준위 사이의 천이인 발머계열의 첫 번째; 스펙트럼 가시광 영역에서 붉은 쪽에 위치한다.
head-tail radio galaxy|머리-꼬리 은하|전파 옆으로 관측되며, 움직여 지나갈 때 주변 물질과의 상호작용으로 꼬리가 형성되는 활동 은하.
heavy-particle era|무거운 입자 시대|뜨거운 대폭발 모형에서 0.001초까지의 시간. 이 때 감마선이 충돌하여 양성자와 같은 질량이 큰 입자를 만들었다.
Hertzsprung-Russell Diagram|H-R 도|스펙트럼 형(型)과 광도에 따라서 별들을 그래프로 나타낸 도표. 도표의 왼쪽위(매우 밝은 푸른색 별들이 여기에 몰려있다.)에서 오른쪽 아래(희미한 붉은 별들이 있다.)로 내려가는 주계열(Main Sequence)로 알려진 매우 명확한 띠를 발견할 수 있다. 또한 거성들의 분파가 오른쪽 위에 있으며, 반면에 희미하고 뜨거운 백색왜성(White Dwarf)들은 왼쪽 아래에 있다. H-R도는 별의 진화에 대한 연구에 있어서 극히 중요한 것이다. 만약 스펙트럼 대신 색지표(Color Index)를 사용한다면, 도표는 색 등급도(C-M 도, Color-Magnitude Diagram)가 된다.
high-velocity clouds|고속도 성운|수백 km/s로 움직이는, 은하와 관련된 기체 구름.
high-velocity stars|고속도 성|태양에 대해서 60km/s이상의 큰 속도를 가진 별 ; 궤도는 이심률이 크고, 종종 은하평면에 대해 크게 기울어져 있다.
H.Ⅰ & H.Ⅱ Region|H Ⅰ, H Ⅱ 구역|우리 은하계내의 수소의 구름들의 지역. H I 구역에서는 수소가 중성이며, 그 구름들은 볼 수 없지만, 그것들의 21㎝의 파장을 가지는 독특한 방출현상 때문에, 전파망원경으로 연구될 수 있다. H II 구역에서는 수소가 이온화되어 있으며, 일반적으로 뜨거운 별이 그 안에 존재한다. 이온과 자유전자의 재결합으로 중성원자가 형성되면서, 빛의 방출을 일어나게 하고, 이것에 의해 H II구역은 붉은 계열의 빛을 내게 된다.
HⅡ region|HⅡ영역|성간 공간에서 이온화된 수소로 이루어진 영역; 보통 뜨겁고 젊은 하나의 별이나 성단 주위에 밝은 성운의 형태를 이룬다.
HⅠregion|HⅠ영역|성간 공간에서 중성 수소로 이루어진 영역.
horizon|지평선|관측자의 위치에서, 지구와 접하는 하늘 평면과의 교선.
horizon distance|지평 거리|우주론에서, 우주의 어떤 시대에 빛이 갈 수 있는 최대 거리.
horizon problem|지평선 문제|대폭발 모형에서 초기 우주가 급속히 팽창함에 따라 다른 지역이 서로 정보를 주고 받을 수 없게 되어 발생하는 문제.
horizontal branch|수평 가지|헤르츠스프룽-러셀 도에서 적색 거성 단계를 지나 질량이 작은 종족 Ⅱ별이 도달하는 위치. 특히 구상성단에서 발견된다. 같은 광도(태양의 약 100배)를 가지며 노란색에서 붉은색을 가지는 별들이 이에 해당된다.
Hour Angle|시각, 時角|천체가 관측자의 자오선과 교차한 때부터 경과된 시간.
Hour Circle|시권, 時圈|하늘의 양 극을 통과하는 천구상의 대원. 0시권(Zero Hour Circle)은 관측자의 자오선과 같다.
H-R diagram|H-R도|헤르츠스프룽-러셀도.
Hubble Constant|허블 상수|한 은하의 거리와 그 후퇴속도와의 관계. 이 값은 아직도 불확실하며, 아마 60㎞/Sec/Mega Pc 정도 일 것이다.(1 메가 파섹당 초속 60㎞정도라는 이야기, 하지만 정확한 허블상수는 아직도 결정되지 못하고 추정만 할 뿐입니다.)
hydrogen burning|수소연소|수소(양성자)를 더 무거운 원소로 바꾸는 핵반응.
hydrogen corona|수소 코로나|물의 분해에 의해 만들어진 수소가 대기를 벗어나 지구 주위에 형성한 수소 기체 껍질.
hydrostatic equilibrium|정유체 역학적 평형|압력 경사력과 중력이 균형을 이루어 질량의 움직임이 없는 상태.
hyperbola|쌍곡선|원추를 자른 면에 의해 만들어지는 곡선; 탈출속도 이상의 속도를 가지는 물체의 궤도 형태.
hyperbolic geometry|쌍곡선 기하학|로바체브스키(Lobachevski)가 직선 근처의 한 점을 지나는 평행선은 하나 이상이라는 전제하에 만든 유클리트 기하학의 또다른 형태; 쌍곡선 위에 그린 삼각형의 내각의 합은 항상 180°보다 작다.
ilmb darkening|주연 감광|광학적 깊이의 효과 때문에 태양의 가장자리가 어둡게 보이는 현상.
image|상|실물과 상대적으로 일직선에 정렬된 렌즈나 거울의 초점에 모인 광선들이 만들어 낸 것.
impact model|충돌 모형|고체 물체가 표면에 충돌하여 구덩이를 형성한다는 모형.
inertia|관성|물체가 질량을 가지고 있기 때문에 물체에 작용하는 힘에 대하여 일으키는 저항.
inertia frame|관성 틀|특수 상대성 이론에서 가속되지 않는, 기준이 되는 어떤 계.
inertia mass|관성 질량|알려진 힘(중력이 아닌 힘)이 물체에 작용하도록 하고. 그 결과에 의한 가속도를 측정함으로써 결정되는 질량.
inferior conjunction|내합|한 행성이 다른 행성의 안쪽에서 궤도운동을 할 때 안쪽의 행성이 바깥쪽의 행성과 태양에 대하여 같은 방향으로 일직선상에 놓이는 상태.
Inferior Planet|내행성|수성과 금성으로, 그 궤도가 지구의 궤도보다 태양에 더 가까이 있는 행성들을 지칭한다. 그들의 적경(Right Ascension)이 태양과 같다면, 그들은 태양과 지구 사이에 있게 되어 내합(Inferior Conjunction)의 위치에 있게 된다. 만약 거기에다가 적위(Declination)까지 같게 되면, 행성의 일면통과 현상이 일어나게 된다.
Infrared Astronomy Satellite, IRAS|적외선 천문 위성|12,25,60,100μm의 파장의 빛으로 하늘을 관측하는 위성.
infrared cirrus|적외선 새털구름(권운)|적외선 천문 위성에 의하여 얻어진 화상에서 권운처럼 보이는, 성간 티끌의 누더기 구름.
Infra-Red Radiation|적외선 복사|적색의 파장보다는 길지만, 극초단파(Micro Wave)의 파장보다는 짧은 파장을 가지는 복사. 하늘의 적외선 원들은 높은 고도의 천문대(마우나 키어(Mauna Kea)에 있는 것처럼)라든지, 아니면 우주에 있는 위성이 아니고선 연구하기가 힘들다. 1983년에 적외선 천문위성인 IRAS(Infra-Red Astronomical Satellites)가 적외선으로 전천(全天)의 조사를 수행하였다.
infrared telescope|적외선 망원경|적외선 감지기를 부착하여 전자기파의 적외선 영역에서 사용하도록 최적화시킨 망원경.
intergalactic medium|은하간 물질|은하들 사이에서 발견된 기체와 티끌.
interstellar dust|성간 티끌|성간 물질을 구성하고 있는 작은 고체 알갱이. 크기는 0.1μm 정도이다.
interstellar extinction curve|성간 소광 곡선|파장의 함수로 나타낸 성간 티끌에 의한 소광량.
interstellar gas|성간 기체|성간 물질을 구성하고 있는 원자, 분자, 이온.
interstellar medium|성간 물질|별들 사이에서 발견되는 모든 종루의 기체와 티끌.
inverse beta decay|역 베타 붕괴|전자와 양성자가 서로 힘을 받아 중성자와 중성미자를 만드는 과정; 중성자 소멸의 역과정.
ion|이온|하나 또는 그 이상의 전자를 얻거나 잃어서 전기적으로 전하를 띤 원자.
ionization|전리|원자가 이온을 얻거나 잃는 과정.
ionized gas|전리된 기체|전리되어 그 안에 자유 전자나 전하를 띤 이온을 포함하는 기체; 전체가 전기적으로 중성이면 플라즈마라고 부른다.
ion meteorite|철운석|약 90%의 철과 9%의 니켈 그리고 미량의 다른 원소들을 포함하는 운석의 주요 종류 중 하나.
ionosphere|전리층|산소와 질소가 햇빛에 의해 이온화되어 자유전자가 만들어지는, 지상에서 100~700km의 지구 대기층.
Ionosphere|전리층, 이온층|성층권(Stratosphere)의 위쪽 구역으로, 약 65~800㎞의 높이에 있다. 이 지역내에서 일어나는 원자들의 이온화가 전파를 반사하는 층을 만들며, 지구 반대편까지 장거리 통신을 가능하게 한다. 태양에서 발생하는 일들은 전리층에 영향을 미치며, 전리폭풍(Ionospheric Storm)이라는 현상도 발생시킨다. 이럴때에는 때에 따라서 전파통신이 불통되기도 한다.
Irradiation|광삼현상, 光渗現像|밝게 비춰지거나 스스로 빛을 내는 천체가 그들의 실제 크기보다 더 크게 보이는 효과. 일례로, 달의 밝은 초승달부분은 지구조(Earthshine)부분보다 더 크게 보인다.
Ishtar Terra|이쉬타르 테라|동쪽에 순상 화산인 맥스웰 몬테스로 경계지워진 금성의 북반구에 있는 넓은 고원 지대.
isophoto|등광선|디지털 상(image)에서의 등세기선.
isothermal pertutbation|등온 섭동|복사장의 파동과는 관련 없는 초기 우주의 물질 성분만의 파동.
isotope|동위원소|같은 수의 양성자를 가지고 있지만 중성자수가 다른 원자.
Jeans length|진스 길이|기체에서 중력 수축을 일으키는 최소 크기의 교란; 물질의 압력, 온도, 밀도에 의존한다.
Jeans mass|진스 질량|진스 길이에 포함되어 있는 질량; 기체 내부에서 교란이 더욱 커지기 위한 최소 질량.
jet steam|제트류|지구나 행성의 상층 대기에 존재하는 빠른 속도의 흐름으로 그 진행 방향이 위도에 평행함.
J, joule|줄|일과 에너지의 물리적 단위.
Jovian planets|목성형 행성|물리적 특징이 목성과 비슷한 행성들; 큰 질량과 반지름, 낮은 밀도, 내부의 대부분이 액체이다.
Julian Day|율리우스 일|B.C 4713년 1월 1일 정오부터 시작한, 날짜들의 총 량. 이 체계는 1582년에 스칼리거(Scaliger)에 의해 제창되었다. "Julian"이란 말은 스칼리거의 아버지를 기념하기 위한 것이며, 율리우스 시저(Julius Caesar)나 율리우스 력(Julian Calendar)와는 아무런 관련이 없다. 율리우스 일은 변광성(Variable Star)관측자들에 의해 사용되고, 긴 기간에 걸쳐있는 현상에 대한 계산을 위해서 사용된다.
K correction|K 보정|은하의 적색 이동에 대한 은하 겉보기 등급의 보정.
Kerpler's 1st Law|1법칙|행성은 타원궤도 내에서 움직이며, 태양이 그 타원의 한 초점에 위치해 있으며 다른 나머지 초점은 비어있다. (타원궤도의 법칙)
Kepler's 2nd Law|2법칙|동경(動徑), 즉 행성의 중심과 태양의 중심을 이은 가상적인 선은 같은 시간 안에 같은 면적을 지나간다. (면적속도 일정의 법칙)
Kepler's 3rd Law|3법칙|행성의 항성주기의 제곱은 태양에서의 그들의 평균거리의 세제곱에 비례한다. (조화의 법칙)
Kepler"s law|케플러 법칙|역제곱 법칙으로 타원 궤도 성질을 기술한, 행성 운동에 대한 케플러의 세가지 법칙.
Kepler's Law Of Planetary Motion|행성 운동에 대한 케플러의 법칙|요하네스 케플러에 의해 1609~1618년 사이에 3개의 중요한 법칙들이 설명되었다. 그것은 다음과 같다.
kiloparsec|kpc|1000파섹
kinematic distance|운동학적 거리|우리 은하에서 도플러 이동, 방향, 은하의 회전 곡선에 의해 알려진 어떤 물체까지의 거리.
kinetic energy|운동 에너지|운동에 의해 일을 할 수 있는 능력.
Kirchhoff"s rules|키르히호프 법칙|스펙트럼의 주요 형태의 기원이 되는 물리적 조건에 대한 경험적인 설명.
Kirkwood Gaps|커크우드 간극|거의 어떤 소행성도 없는, 화성과 목성 사이의 소행성(Asteroid)대 안에 있는 구역. 목성의 중력적인 영향으로 이 구역은 "청소되어 있는" 상태를 유지한다. 커크우드 구역에 들어온 소행성은 그 궤도가 바뀌어질때 까지 목성에 의해 일정하게 섭동을 받게 된다. 이러한 사실은 미국의 수학자인 Daniel Kirkwood가 처음으로 발견하였다.
Kleinmann_Low nebula|클라인만-로우 성운|오리온 성운의 근처에 있으며 원적외선 파장에서 강하게 빛을 내는 온도 약 70K인 부정형 티끌 성운.
KREEP|크립|칼륨(K), 희토류 원소(REE), 인(P)로 구성된 달의 물질.
Large Magellanic Cloue, LMC|대마젤란 성운|은하수에서 약 50kpc 떨어진 불규칙한 형태의 작은 은하. 마젤란이 처음 발견하였을 때는 성운이라고 생각했다.
Latitude, Celestial|황위, 黃緯|황도(Ecliptic)에서 가장 가까운 점에서 천체까지의 각 거리. 즉 황도에서의 각 거리
law of gravitation|중력의 법칙|뉴턴의 만유 인력의 법칙.
lens|렌즈|광선을 초점에 모으도록 고안한 곡면의 유리 조각.
lenticular galaxies|렌즈형 은하|나선 은하와 같은 원반을 가지지만, 나선팔은 없고 기체나 먼지도 없는, 허블의 분류에서 S0은하.
lepton|렙톤|약한 핵력에 참여하는 기본 입자(예를 들어, 전자).
Libration, Lunar(달의 칭동|秤動)|비록 달의 자전이 지구에 대해 포획되어서 자전주기와 공전주기가 같다고 해도, 칭동이라 알려진, 다양한 효과들이 일어나게 되어서, 단 한번에는 물론 50%밖에 달 표면을 볼 수 없지만, 전체적으로는 59%의 달 표면을 볼 수 있게 해준다. 칭동에는 세가지 종류가 있는데, 경도 칭동은 달의 자전 속도가 일정하지 않아서(왜? 달의 궤도도 타원이니까) 일어나며, 위도 칭동은 달의 적도가 궤도면에 대해서 6˚정도 기울어져 일어난다. 마지막으로 일주 칭동은 지구의 자전때문에 일어난다.
lift valley|열곡대|지괴의 분리에 의해서 행성의 표면에 생긴 골짜기.
light curve|광도 곡선|시간에 따라 별빛의 세기가 변하는 모습을 나타낸 그래프.
light gathering power, LGP|집광력|대물 렌즈나 대물경의 면적에 관계하는, 망원경의 빛을 모으는 능력.
light house model|등대 모형|펄서를 설명하기 위한 강한 자기장과 고속으로 회전하는 중성자별 모형; 회전은 펄서에 주기를 작게 하고 자기장은 전자기 복사를 하게 한다.
light rays|광선|빛의 파동이 진행하는 방향으로서의 가상적인 선.
light year|광년|빛이 1년에 가는 거리. 약 3.09×1013km
Limb|분도권|태양, 달, 행성, 또는 (우주에서 보았을 때의) 지구 등의 가장자리 부분.
line profile|선폭|파장의 함수로 나타낸 스펙트럼선 세기의 변화 폭.
line spectrum|선 스펙트럼|전자가 서로 다른 에너지 준위로 천이를 할 때 해당하는 파장의 빛이 방출되어 보임.
Local Group|국부 집단|우리 은하가 속해있는 약 20개의 은하들이 중력적으로 묶인 집단.
Local Group Of Galaxies|국부 은하군|우리은하가 한 구성원인 은하군. 여기에는 24개 이상의 은하계가 있으며, 그들 중 가장 비중이 있는 은하들은 안드로메다 나선은하, 삼각형자리 나선은하, 그리고 두개의 마젤란 운(雲)이다.
Local Supercluster|국부 초은하단|국부 집단이 위치하는 곳의 은하들의 초은하단 ;107 pc에 걸쳐 퍼져있고, 처녀자리 은하단과 머리털자리 은하단을 포함한다.
Longitude, Celestial|황경, 黃經|춘분점에서 천체로부터 황도(Ecliptic)와 만나는 부분까지의 그려진 수직선의 교점까지의 각 거리. 이것은 황도의 동쪽을 따라서 0˚~360˚의 값을 가진다.
longitudinal wave|종파|속도는 물질의 밀도에 의존하며, 고체, 액체, 기체와 같은 매질에서 밀고 잡아당기는 운동으로 진행하는 파.
long-period comet|장주기 혜성|궤도 주기가 200년보다 긴 혜성.
low-ionization nuclear emission region, LINER|저이온화 핵 방출 영역|활동 은하핵의 활동이 최저수준인 방출선 은하의 한 형태.
low-velocity stars|저속도 별|우리 은하 평면에서 원궤도에 가까운 별; 태양에 대해서 60km/s 이하의 속도로 움직인다.
luminosity|광도|모든 파장에 대한 천체의 총 복사에너지, 태양의 광도는 약 4×1026W
luminosity class|광도 계급|표면온도는 같으나 크기가 달리 나타나 별들의 광도 차이를 의미하는 계급; 별의 스펙트럼에서 나타나는 흡수선의 폭을 바탕으로 한다. 거성은 왜성보다 선폭이 좁다.
luminosity function of galaxies|은하의 광도 함수|은하의 광도를 변수로 나타낸 단위 부피당 은하들의 수에 대한 함수.
lunar eclipse|월식|달이 지구와 태양이 이루는 직선상에 놓였을 때 달이 지구의 그림자를 지나가게 되어 반사하는 태양 빛이 가려지는 현상. 월식은 망일 때만 일어나며 만월이 황도면에 아주 가깝게 놓여 있을 때 일어난다.
Lunar eclipse |월식|달이 지구에 의해 투사된 그림자 속을 지나갈 때 일어나게 된다. 월식 역시 개기식과 부분식이 있다. 일반적으로, 달은 완전히 사라지는 것처럼 보이게 되지는 않는데 왜냐하면 일부 태양빛이 지구대기에 의해 굴절되어 달에 도달하기 때문이다.
lunar occultation|달의 엄폐|달이 별이나 행성의 전면을 지나는 현상.
lunar soil|달의 토양|운석 충돌로 인하여 달 표면에 형성된 미세한 입자들이 커다란 암편들과 함께 달의 토양을 구성하고 있다.
Lunation (또는 Synodical Month) (태음월(太陰月), 삭망월|朔望月)|연속적인 신월(New Moon)사이의 간격. 29일 12시간 44분이다. 후에 나오는 상합주기(Synodic Period)도 볼 것.
Lyman series|라이만 계열|수소 원자에서 가장 낮은 에너지준위(기저상태)에서 시작되거나 끝나는 모든 천이; 스펙트럼에서 자외선 영역에 해당하는 에너지 변화를 수반한다. 또한, 이 천이와 관련되는 흡수 또한 방출선이 나타난다.
Lyot Filter(또는 Monochromatic Filter) |리오트필터, 단파장 필터|개기 일식을 기다릴 필요없이, 태양의 홍염(Prominence)과 다른 태양대기에서 일어나는 현상들을 관측하기 위해 사용되는 기구, 이것은 프랑스의 천문학자인 B. Lyot에 의해 발명되었다.
M31|안드로메다 은하(Andromeda galaxy)|은하계에서 가장 가까운 나선은하 (거리:680kpc). 지름은 50kpc이다.
Mach number|마하수|어떤 물질에서 물체의 속도와 음속의 비.
Magellanic cloud|마젤란 성운|남반구에서 육안으로 볼 수 있는, 이웃한 두 은하들, 대마젤란 성운(LMS), 소마젤란 성운(SMC) ;우리 은하의 동반은하.
Magentohydrodynamics|전자기 유체역학|자기장과 전기적으로 전도성을 가진 유체 사이의 상호작용에 대한 학문. 스웨덴의 H. Alfven이 전자기 유체역학의 창시자로 여겨지고 있다.
magnetic field|자기장|물체에 자기력을 작용할 잠재력을 가지고 있는 공간의 성질.
magnetic field line|자기력선|자기장의 방향을 나타내며 그 밀집 정도로 자기장의 세기를 표시하는 그림에 쓰이는 선.
magnetic flux|자기속|단위 면적을 지나는 자기력선의 수.
magnetic monopole|자기홀극|대통일장 이론에 의하여 예견된, 단지 한 형태의 자극을 가진 입자.
magnetic reconnection|자기 재연결|갑자기 자기력선이 반대 극으로 연결되는 현상.
Magnetic Storm|자기 폭풍|지구의 자기장의 갑작스런 도용이며, 나침반 바늘의 변동 뿐만 아니라, 전파 통신의 방해 현상도 일어난다. 이것은 태양으로부터 방출된, 때때로 폭발 플레어(Flare)와 연관이 있는 대전된 입자에 의해 발생한다. 자기 뜨개질 현상(Magnetic Crochet)은 자기장 내의 갑작스런 변화로, 하부 전리층(Lower Ionosphere)내의 상태가 변화하는 것 때문에 발생한다. 자기 뜨개질 현상은 플레어의 갑작스런 변화와 연관이 있으며, 그것과 함께 시작된다. 자기 폭풍은 입자들과 연관이 있으며, 그 입자들은 대략 24시간 후에 지구에 도달한다.
Magnetic Variation |자기편차|자북과 진북사이의 각도차. 이것은 지구 표면상의 모든 장소에 대해 같은 것은 아니며, 또한 자극의 이탈현상 때문에 해마다 조금씩 변하고 있다.
magnetometer|자기 측정기|자기장의 세기를 측정하는 장치.
magnetosphere|자기권|태양풍으로부터 온 입자들이 자기장에 의해 갇혀있게 되는 행성 주위의 지역.
Magnetosphere|자기권|한 천체의 자기장이 차지하고 있는 천체 주위의 구역. 태양계에서는 목성이 가장 큰 자기권을 가지고 있다. 다른 거대행성뿐만 아니라, 지구와 수성 역시 뚜렷한 자기장을 가지고 있지만, 달, 금성, 화성은 그렇지 않다.
magnitude|등급|물체의 밝기를 천문학적으로 측정한 것; 등급이 클수록 빛이 흐리다.
Magnitude|등급|이것은 실제로는 "밝기"를 나타내기 위한 용어이지만, 몇 가지 종류가 있다.
maim sequence|주계열|헤르츠스프룽-러셀도에서 기본 계열의 별들; 이러한 별들은 핵에서 양성자-양성자 반응이나 탄소-탄소-산소 순환 반응으로 수소가 헬륨으로 변한다. 별의 일생 중 주계열에서 가장 긴 시간을 보내게 된다.
Main Sequence|주계열|H-R도의 왼쪽 위에서 오른쪽 아래까지의 매우 명확한 띠 구역. 태양은 전형적인 주계열성이다.
major axis|장축|타원의 2개의 축 중에서 더 긴 것.
mantle|맨틀|소성(塑性)의 감람석으로 구성된, 지각 아래 지구 내부의 주요 부분.
mare|달의 바다|고원지대보다 어둡고 부드럽게 보이는 달의 낮은 지대. 아마도 3~3.5*109년 전에 용암에 의해 형성된 후 현무암으로 고화되었을 것이다. 라틴어로 sea
mare basalt|달의 바다 현무암|달의 바다 표면에서 발견되는 암석; 달 표면에서 (가장 최근에 형성된) 가장 젊은 암석으로 나이는 약 3.2*109 이다.
mascons|메스콘|달의 바다 아래에 비정상적인 질량의 집중. 달 궤도 및 인공 위성의 궤도에 영향을 미치는 효과로 발견되었다.
mass|질량|운동 상태의 변화에 따라 물체가 저항하는 정도(관성 질량); 물체가 만들어 내는 중력의 크기에 대한 정도(중력 질량).
mass loss|질량 손실|항성풍에 의하여 일년 동안 별이 질량을 잃는 률.
mass-luminosity relation|질량-광도 관계|주계열별에서 대략적으로 질량의 세제곱 정도에 비례하는 광도 사이의 경험적인 관계.
matter era|물질 시대|대폭발 모형에서 대폭발 이후 100만 년부터 지금까지, 우주에서 물질이 우세했던 시대.
maximum elongation|최대 이각|천체가 태양으로부터 가장 크게 떨어져 보일 때의 천체와 태양의 각거리.
mechanics|역학|힘이 물체에 작용했을 때의 효과에 대해 다루는 물리학의 한 분야.
megaparsec|1Mpc|1백만 파섹.
megaton|메가톤|TNT1백만 톤에 상당하는 폭발력(약 4*1015J)
Meridian Celestial|천구 자오선|지평선의 남점과 북점을 통과하여 그려지는 가상적인 대원. 천정(Zenith)과 양 천극(天極)을 지나는 천구상의 대원. 자오선은 정확한 북쪽과 남쪽에 있는 관측자의 지평선과의 교점을 지난다.
meson|중간자|정수의 스핀을 가지는 쿼크로 구성된 입자.
mesosphere|중간권|온도가 급격히 떨어지는 50~100km 사이의 지구 대기권.
Messier Number|메시에 번호|18세기 프랑스의 천문학자인 샤를 메시에(Charles Messier)에 의해 산개성단, 구상성단, 가스 성운, 은하들을 포함하는 다양한 성운 형태의 대상들에게 주어진 번호. 메시에 목록에는 백개가 약간 넘는 대상들을 포함하고 있다. (전부 110번까지 있으며, 실제로는 108개의 대상이 수록되어 있다.) 그의 번호는 아직도 사용되고 있으며, 안드로메다 나선은하는 M31, 오리온 대성운은 M42, 게 성운은 M1등의 번호가 붙어있다.
metallic hydrogen|금속 수소|압력이 높아져서 전기를 통할 수 있을 정도의 수소 상태.
meteor|유성|고체 입자(유성체)가 지구 대기권으로 들어올 때 생기는 밝은 빛의 줄기.
Meteor|유성체|혜성의 부스러기들. 지구 상층 대기에 들어와서 타버리는 자그마한 조각이며, 유성(Shooting Star)으로 알려진 현상을 발생시킨다.
Meteorite|운석|지구 대기권을 통과할 때 소멸되지 않고 지면으로 떨어진, 우주 공간에서 온 고체 물질. 운석과 유성체 사이에는 근본적인 차이가 있다. 운석은 소행성(Asteroid)과 더 가까운 관련이 있는 것으로 보인다. 운석은 돌로 되어 있거나(석질운석, Aerolite), 철로 구성되었거나(철질운석, Siderite) 또는 중간 형태를 지니고 있다. 몇몇 경우에는 운석은 지표상에 크레이터를 형성한다. 가장 유명한 것은 아리조나 주에 있는 거대 크레이터이며, 이것은 직경이 거의 1.5㎞이고, 선사시대에 형성된 것으로 추정된다.
meteorite falls|낙하 유성|하늘에서도 보이며 땅에서도 발견된 운석.
meteorite finds|발견유성|떨어지는 것은 보이지 않았으나 발견된 운석.
meteoroid|유성체|태양 주위의 궤도에서 우주 공간을 움직이는 매우 작은 고체 천체.
meteor shower|유성우|복사점이라 불리는 하늘의 좁은 영역으로 들어오는 것처럼 보이는 유성들의 빠른 유입.
meteor stream|유성 흐름|태양 주위의 궤도를 따라 형성된 유성체들의 균일한 분포.
meteor swarm|유성 떼|태양 중심 궤도의 국부적인 지역에 집단을 이룬 유성체들; 유성우의 근원.
meteor trail|유성 자취|대기를 통과할 때 공기의 이온화와 유성체의 증발로 만들어진, 눈에 보이는 유성의 궤적.
micrometeorite|미세운석,유성진|지면에 도달하기 전에 냉각되어 고화된 매우 작은 운석(지름이 약 1/10μm) 태양의 주위를 돌고 있는, 직경이 0.01016㎝이하인, 극단적으로 작은 알갱이들. 유성진이 지구 대기 속으로 들어와도, 그들의 질량이 너무 미미하기 때문에, 유성현상을 만들어 낼 수가 없다.
microwave background radiation|마이크로파 배경 복사|온도가 약 2.7K에 해당하는 흑체 복사 스펙트럼을 가지는, 에너지가 낮은 광자들의 우주 복사.
midoceanic ridge|중앙 해령|지구 해양저를 통하여 64,000km 정도 확장되어 있는, 거의 연속적인 바다 속의 산맥.
Milky way|은하수|우리 은하의 평면 근처에 있는 많은 별들로부터 온 빛이 섞여져서 만들어진, 하늘을 원형으로 둘러싼 빛의 띠, 태양이 속해 있는 우리 은하를 언급하는데 주로 사용된다.
millisecond pulsar|밀리초(세컨드) 펄서|펄스의 주기가 수 밀리초인 펄서에 붙인 일반적인 이름.
minimum resolvable angle|최소 분해각|망원경으로 선명하게 분해하여 볼 수 있는 최소각.
momentum|운동량|물체의 질량과 속도의 산물.
moving-cluster method|운동 성단법|시선 속도와 그들의 고유 운동이 수렴하는 지점을 결정함으로써 성단까지의 거리를 구하는 방법.
M-type asteroid|M형 소행성|반사도가 약 10%이하이고, 금속과 비슷한 반사 성질을 지닌 소행성.
Multiple Stars|다중성|두 개 이상의 물리적으로 연결된 구성요소로 이루어진 별이며, 그들의 중력공통중심 주위를 돈다.
muon|뮤온|렙톤 중의 하나.
Nadir|천저, 天底|관측자의 바로 아래에 있는 천구상의 점. 이것은 머리 위의 점, 즉 천정(Zenith)과 정확히 반대쪽에 있게 된다.
namometer|나노미터(nm)|10-9m; 빛의 파장을 측정하는 단위.
narrow-line region, NLR|좁은 선 영역|상대적으로 금지된 방출선을 내는, 활동 은하핵 근처의 기체 영역.
narrow-tailed radio galaxies|좁은 꼬리를 가진 전파 은하|핵 뒤에 U자형 꼬리를 가지는 전파 은하; 은하단에서 빠르게 움직이는 은하.
natural motion|자연 운동|힘이 작용하지 않는 운동.
nebula|성운|성간기체와 티끌의 구름. (구름에 대한 라틴어)
nebula model|성운 모형|기체와 먼지로 된 성간운이 중력적으로 붕괴하여 평평한 원반을 만들고 부착에 의해서 행성들이 형성된다는 태양계의 기원에 관한 모형.
Neutrino|뉴트리노, 중성미자|질량이나 전하 값이 없는 기본 입자중의 하나. 중성미자는 검출하기가 매우 어렵다.
neutron|중성미자|광속으로 움직이며, 질량이 없고(혹은 매우 작고) 전하를 띠지 않는 단위 입자(렙톤); 핵 반응시 에너지를 갖고 달아난다. 양성자(Proton)의 질량과 같은 질량 값을 가지지만, 전하 값이 없는 기본 입자. 중성자들은 수소를 제외한 모든 원자핵 속에 존재한다.
Neutron Star|중성자 별|대부분의 또는 완전히 중성자들로 이루어진 별. 그래서 중성자 별은 광도가 낮지만, 거의 믿을 수 없을 정도로 높은 밀도를 가지게 된다. 이론적으로, 중성자 별은 별의 일생에서 마지막 단계를 나타내고 있다. 펄서(Pulsar)로 알려진 주목할만한 전파 발생원들이 실제로는 중성자 별임이 틀림없을 것으로 현재 생각되고 있다.
new moon|삭|달이 하늘에서 태양의 방향과 같은 곳에 위치하여 지구에서 볼 때 거의 완전히 보이지 않는 상태의 위상.
Newtonian reflector|뉴턴식 반사경|망원경의 경통 중앙에 45°각도로 작은 거울을 설치하여 경통 밖으로 초점을 나오게 한 망원경.
newton|뉴턴 |힘의 SI 단위.
Noctiucent Clouds|야광운, 夜光雲|희귀하고 별난 구름들로 전리층 내에 있으며, 해가 진 후에 햇살을 계속 받는 밤에 가장 잘 보인다. 이것들은 80㎞이상의 고도에 있으며, 일반적인 구름과는 현저하게 차이가 있다. 이 구름들은 상층대기에 있는 유성진에 의해 생겨난 것으로 추정된다.
Nodes|교점|천체가 남에서 북으로 움직이거나(상승교점 생성), 북에서 남으로 움직임으로써(하강 교점 생성), (행성, 달, 혜성등의) 궤도가 황도면을 지나가는 지점. 이 들 두점을 연결한 선을 교선(Line Of Nodes)이라고 한다.
noon|오정|한낮; 태양이 수평선에 대해서 하늘의 최고점에 도달했을 때로서 일몰과 일출의 중간 시간.
Norma arm|수준기 팔|태양에서 우리 은하의 중심인 수준기자리 쪽으로 약 4000pc 떨어진 곳에 있는 우리 은하의 나선팔의 한 부분.
north magnetic pole|자북극|나침반 자침의 북극으로 별이나 행성에서 자기력선이 나오는 두 지점 중의 하나.
nova|신성| 'new'에 대한 라틴어. 밝기가 수백 배에서 수천 배로 갑자기 증가하여 급격히 많은 양의 에너지를 방출하는 별; 쌍성계에서 축퇴된 별이 폭발하는 것으로 믿어진다. 현대 천문학자들이 초신성이라고 부르는 별의 폭발에 대해 언급할 때 과거에 사용했던 것.
nucleus of an atom|원자의 핵|전자 궤도 위치에 중성자와 양성자를 포함하는 원자에서 질량이 큰 중심 부분.
nucleus of the galaxy|외부 은하의 핵|늙은 종족 Ⅰ별들과 얼마 간의 기체와 먼지를 포함하고, 많은 은하들에 대해서 비열적 복사원이 집중된, 은하의 중심 부분.
number density|개수밀도|단위 부피당 입자수.
Nutation(장동|章動) 현상|미미하고 느린 지구축의 '흔들림'이며, 달이 때때로 황도의 위나 아래쪽에 있어서 지구의 적도 팽창부(Equatorial Bulge)를 태양과 항상 같은 방향으로 당기지 않는다는 사실 때문에 발생하게 된다. 이 결과, 천극(天極)이 대략 9초각 정도로 18년 220일의 기간동안 천극의 평균위치 양쪽으로 "흔들리는 것"처럼 보이게 된다. 장동현상은 세차운동(Precession)에 의해 발생하는 더 규칙적인 천극의 이동에 겹쳐서 일어난다.
OB association|OB 성협|작은 부성협들로 이루어진 OB별의 느슨한 집단; 중력에 의해 구속되지 않으므로 107년의 몇 배 정도의 시간이 지나면 흩어진다.
Object-Glass(또는 Objective) |대물렌즈|굴절식 망원경의 중심렌즈
objective|대물 렌즈(거울)|망원경에서 빛을 모으는 주렌즈 또는 거울.
Obliquity Of The Ecliptic|황도경사각|황도와 천구 적도간의 각도. 이 값은 23˚26´54˝이다. 이것은 또한 궤도에 대해 수직인 면으로부터 기울어진 지구축의 각도로써 정의될 수도 있다.
observable universe|관측 우주|빛으로 관측되는 우주의 일부분.
OB subgroup|OB부정협|OB 성협 내에서 수십 파섹의, 약 10개의 OB별로 이루어진 작은 모임.
Occultation|엄폐|한 천체가 다른 천체에 의해 가려지는 현상. 그래서 달은 별이나 (때때로) 행성 앞으로 지나가기도 한다. 그리고 행성이 별을 엄폐하기도 한다. 심지어는 한 행성이 다른 행성을 엄폐하는 경우도 있었다. 일례로, 1590년에 금성이 화성을 엄폐했었다. 엄격히 이야기하자면, 일식(Solar Eclipse)도 달에 의한 태양의 엄폐이다.
Olber"s paradox|올버스의 역설|무한한 공간에 무한한 수의 별이 균일하게 분포되어 있다면, 밤하늘은 현재 보이는 것과는 반대로 별의 표면만큼이나 밝을 것이라는 설.
Olympus Mons|올림포스 산|화성의 표면 중 타르시스 산맥 지역의 커다란 순상 화산.
Oort"s cloud|오르트 구름|태양계 주위의 궤도를 도는 혜성핵의 구름으로 태양계가 형성되던 당시에 형성되었다. 새로운 혜성의 저장고 역할을 한다.
Oort"s constant|오르트 상수|오르트 방정식에서 차등 은하 회전을 정의하는 상수. 태양이 은하의 중심에서 떨어진 거리와 동경의 함수로 표현된 가속도를 나타내는 상수이다. 현재값은 15km/s/kpc
open cluster|산개 성단|은하 성단과 동일.
opposite|충|지구에서 볼 때 천체가 하늘에서 태양과 반대 방향에 놓여 있을 때; 태양의 이각이 180°인 때.
Opposition|충, 衝|행성이 하늘에서 태양의 정반대쪽에 있을 때의 행성의 위치이며, 그래서 그 위치는 자정에 남쪽에 놓여있게 된다. 충의 위치에서 태양과 지구와 행성은, 지구가 가운데 위치한 거의 일직선이 된다. 분명히 내행성들은 결코 충이 될 수가 없다.
optics|광학|빛의 반사나 굴절을 연구하는 학문
orbital angular momentum|궤도 각운동량|공전하는 물체의 각운동량; 물체의 질량, 궤도 속도, 계의 질량 중심에서 떨어진 거리와의 곱으로 표현된다.
orbital inclination|궤도 경사|물체의 궤도면과 어떤 기준면 사이의 각; 태양계 행성의 경우, 기준면은 지구 궤도면이다. 위성의 경우, 기준면은 보통 행성의 적도면이다. 쌍성의 경우, 기준면은 시선에 수직한 면이다.
Orion arm|오리온 팔|은하의 커다란 나선팔 구조의 일부분; 태양계가 이 안에 있다.
Orion nebula|오리온 성운|고온의 이온화 기체 구름으로, 최근에 별에 형성된 영역이다. 오리온 별자리의 칼 부분에 위치하며 메시에 42(M42)라고도 부른다.
outgassing|기체 이탈|기체로 이루어지지 않은 물질에서 기체가 이탈하는 현상; 행성이 형성된 후 행성체에서 기체가 탈출하는 현상.
ozonosphere|오존층|ozone layer, 표면에서부터 40~60km 상공에 위치한 지구 대기의 하나의 층 ; 오존으로 특징 지워진다.
Parallax, Trigonometrical|삼각시차|두 개의 다른 방향에서 관측했을 때의 물체의 겉보기 이동. 두 관측지의 분할선은 기준선으로 불린다. 지구의 궤도는 3억㎞의 기준선을 제공한다. (왜냐하면, 궤도 반경이 1억 5천만㎞ 정도이니까) 그래서 6개월 간격으로 별을 관측하면 그 별은 더 멀리 떨어진 별을 배경으로 뚜렷한 시차이동을 나타내게 될 것이다. 이런 방법으로 1838년에 베셀(Bessel)이 별(백조자리 61번별이였다.) 까지의 거리를 최초로 측정하였다. 이 방법은 약 300광년까지는 유용하지만, 그 이상의 거리에서는 시차에 의한 이동이 감지하기 어려울 정도로 작아진다.
parent meteorite bodies|운석 모체|작은 고체 전체로서, 크기는 수백에서 수천km이고, 니켈-철 운석의 근원으로 여겨진다. 태양계 역사 중 초창기에 형성되어 그 후 충돌로 부서진 것이다.
Pariastron|근성점, 성간 최근점|별들이 서로 근접해있는 연성계의 한 별의 궤도상의 점. 가장 멀리 떨어져 있는 지점은 원성점(Apastron)으로 불린다.
Parsec|파섹, Pc|1초각의 시차를 나타내는 별까지의 거리. 이것은 32.6광년, 206265AU, 또는 3080경㎞와 같다. (태양을 제외하고, 사실상 우리에게서 1파섹의 이내에 있는 별은 없다.)
Penumbra1|반암부|흑점(Sunspot)부분을 둘러싸고 있는 비교적 밝은 부분
Penumbra2|반영부|지구에 의해 투시된 본 그림자의 원추형 양쪽에 있는 부분그림자의 지역. 월식 동안에 달은 본그림자, 즉 본영부(Umbra)에 도달하기 전에 반드시 반영부를 통과한다. 몇몇 월식은 단지 반영식(半影蝕)이다.
perfect cosmological principle|완전 우주 원리|우주는 관측자에게 모든 위치, 모든 시간에 걸쳐 똑같이 보인다는 원리.
Perigee|근지점|달이나 인공위성 등의 궤도 내에 있는, 그 천체가 지구에서 가장 가까운 곳의 위치. 가장 멀리 떨어진 지점은 원지점(Apogee)이다.
Perihelion|근일점|태양계 내의 한 구성원의 궤도 내에 있는, 그 천체가 태양에 가장 근접한 곳의 위치. 가장 멀리 떨어진 지점은 원일점(Aphelion)이다. 지구는 1월 초에 근일점에 도달한다.
period|주기|어떤 규칙적인 사건이 일어나는 시간 간격; 예를 들어, 한 물체가 다른 물체 주위를 한 바퀴 도는데 걸리는 시간.
periodic comets|주기 혜성|태양 주위를 비교적 작은 타원 궤도를 그리면서 공전하는 혜성으로, 그 주기는 200년 보다 짧다.
periodic regular variables|주기 변광성|여러 가지 이유로 인해 별빛이 시간에 따라 규칙적으로 변하는 별.
period-luminosity relation|주기- 광도 관계|세페이드 변광성의 평균 광도와 그 광도가 변하는 시간 주기와의 관계; 광도가 클수록 주기는 더 길다.
Perturbations|섭동, 攝動|다른 천체들의 중력의 끌어당기는 힘에 의해 발생되는 천체 궤도 내의 동요.
phase of the moon|달의 위상|지구에서 볼 때, 달의 모양이 한 달을 주기로 변하는 모양. 삭일 때 달은 태양 반대방향으로 놓여 있어 보이지 않는다. 망일 때 달은 태양 반대방향에 놓여 있어서 달의 표면을 모두 볼 수 있다.
Phase(상(相), 위상|位相)|우리를 향하고 있는, 태양빛이 비추어진 반구의 양에 좌우되는 달과 몇몇 행성의 모양에서의 겉보기 변화들. 달, 수성, 금성은 삭(朔)에서 망(望)까지 완벽한 위상들을 나타낸다. 화성은, 때때로 90%이하의 햇빛에 비친면이 우리 쪽을 향하기 때문에, 약간의 상변화를 나타내기도 한다. 더 바깥쪽의 행성들의 상은 의미가 없다.
photo-dissociation|광해리|분자가 분자 결합을 깨뜨릴 정도의 에너지를 빛으로 흡수하여 부서지는 현상.
photo-excitation|광여기(들뜸)|원자를 둘러싸고 있는 전자가 광자를 흡수함으로써 높은 에너지 준위로 천이하는 현상.
Photographic Magnitude|사진 등급|사진 건판상의 별의 영상의 크기에서 도출된 등급.
photometer|광전 측광기|망원경의 초점에 위치한 빛에 민감한 검출기. 적은 빛의 복사속을 정밀하게 측정할 때 사용한다.
Photometry|측광법, 測光法|빛의 강도의 측정. 별의 등급의 정확한 결정을 위해 사용되는 기구는 광전 광도계(光電光度計, Photoelectric Photometer)이며, 이것은 망원경과 함께 사용되는 광전지(Photoelectric Cell)로 구성되어 있다. 광전지는 일종의 전자 장치이다. 빛이 이 전지에 닿으면 전류가 발생하며, 그 전류의 세기는 빛의 광도에 좌우된다.
photon|광자|빛 에너지의 연속적인 양, 광자의 에너지 E와 주파수 f사이에는 E=hf의 관계가 있다.(h는 플랑크 상수)
photosphere|광구|밝게 보이는 태양의 표면. 태양으로부터 가시광이 방출되는 부분.
physical universe|물리적인 우주|직접 보이는 우주와 물리 법칙으로부터 추론되는 우주를 합친 우주의 개념.
Planet|행성|항성의 주위를 도는 빛을 내지 않는 천체. 다른 항성들도 태양계와 비슷한 행성계를 가지고 있는 것 같지만, 아직 뚜렷한 증거는 없다. (이것도 예전 자료다보니.. 많이 차이점이 생기는군요. 현재는 페가서스 51번별 주위에서 최초의 외행성이 발견된 이후로  200여개 이상의 외행성계가 알려져 있습니다. 최근에는 형성구조가 태양계와 비슷한 것으로 추정되는 행성계가 발견되어서 화제이지요)
Planetarium(플라네타리움, 천문관|天文館)|커다란 돔의 내부표면에 인공적인 하늘을 나타내기 위해서, 또 모든 종류의 천문 현상들을 재현하기 위해서 사용되는 기기. 플라네타리움 영사기는 엄청나게 복잡하고, 매우 정교하다. 플라네타리움은 교육적인 장치이며, 근년에 매우 인기가 높아졌다. 플라나테리움들은 전세계에 걸쳐 다수의 큰 도시에서 설립되어 왔으며, 학교와 대학에서도 사용되고 있다.
Planetary Nebular(행성상|行星狀) 성운|멋진 희박한 기체의 "껍질"에 의해 둘러싸여진 희미한 별. 우리 은하내에서는 300개 이상이 알려져있다. 그것들이 그렇게 불리는 이유는 저배율에서 망원경으로 볼때, 그들의 형태가 행성의 모습과 비슷하기 때문이다.
planetesimal|미행성(체)|태양계가 만들어질 때 여러 개가 모여 원시행성을 만드는 유성 크기의 천체.
Plasma|플라즈마, 전리기체|몇몇 중성입자들과 함계, 이온화된 원자들과 자유전자들로 구성되어 있는 기체. 전체적으로 볼 때, 이것은 전기적으로 중성이며, 전기의 양도체이다.
Pole, Celestial|천극, 天極|지구의 축을 확장시켜서 천구와 닿는 지점. 북천극과 남천극이 있다.
poloidal magnetic field|극방향 자기장|두 극과 자오선을 따라서 자기력선을 갖는 자기장.
Population Ⅱ stars|종족 Ⅱ형 별|구상 성단이나 은하의 헤일로에서 발견되는 별로서 나이는 종족 Ⅰ형 별보다 많고 중원소 함량은 적다.
Population Ⅰstars|종족 Ⅰ형 별|나선 은하의 원반에서, 특히 나선팔에서 발견되는 밝고 뜨거운 젊은 별, 중원소의 함량은 태양(전체의 2%)과 비슷하다. 늙은 종족Ⅰ형 별은 타원 은하나 나선 은하의 핵에서 주로 발견된다.
Population, Stellar|별의 집단|별 영역의 두 가지 주요한 형태. 제 1형 집단(Population Ⅰ)지역은 다량의 성간물질들을 포함하고 있으며, 가장 밝은 별들은 뜨겁고 하얀 별들이다. 이곳에서 별의 형성이 계속 진행중일 것이라고 추정되고 있다. 제 2형 집단(Population Ⅱ)지역 내에 있는 밝은 별들은 적색 거성들이며, 그들의 진화주기에서 꽤 나이를 먹은 별들이다. 이곳에는 뜨겁고 흰색 거성인 별들이 거의 없으며, 성간 물질도 거의 없어서, 별의 형성이 분명히 멈추어져 있다. 비록 엄격한 경계지역을 절대로 규정지을수는 없지만, 나선은하들의 팔에 해당하는 활 모양 지역은 주로 제 1형 집단들이라고 말할 수 있다. 타원은하나 구상성단, 또 나선은하의 중심부분들은 주로 제 2형 집단들이다.
Position Angle|위치각|다른 대상에 대하여 중심 대상의 북쪽 지점으로부터 동쪽(90˚), 남쪽(180˚), 서쪽(270˚) 방향으로 측정되는 어떤 대상의 겉보기 방향.
positron|양전자|양의 전하를 띤 전자의 반입자.
potential energy|위치(퍼텐셜) 에너지|위치의 변화로 인하여 가지게 되는 일할 수 있는 능력으로 저장이 가능하므로, 나중에 다른 형태의 에너지로 발산되기도 함.
pp chain|양성자-양성자 고리(proton-proton|4개의 수소가 헬륨으로 바뀌는 열핵 반응. 태양의 경우 에너지가 이 반응에 의해서 생긴다고 여겨진다.
precession of Mercurys, orbit|수성 궤도의 세차운동|주위 별들에 대해 1세기에 43초씩 수성 궤도의 장축이 움직이는 운동.
precession of the equinox|춘분점의 세차 운동|지구의 자전축이 흔들리기 때문에(장동) 춘분점이 황도대의 별들에 대해 천천히 서진하는 운동.
Precession|세차歲差 운동|천극들의 외관상 느린 운동. 이것은 지구의 적도 팽창부(Equatorial Bulge)에 대한 달과 태양의 인력에 의해 발생한다. 지구는, 어느 정도 속도가 줄어서 흔들리기 시작한 팽이와 같은 방식으로 움직이지만, 그 움직임은 매우 느리다. 극은 천구상에다가 황도의 극(The Pole Of Ecliptic)을 중심으로 하는 원을 그리며, 이 원은 47˚의 각직경을 가지고, 완전히 이 원을 일주하는 데에는 25800년이 걸린다. 세차 운동 때문에, 천구 적도도 움직이게 되며, 이것은 또한 춘분점의 위치에 영향을 주게 되므로, 춘분점은 매년 50˝각 정도 황도를 따라서 서쪽으로 이동한다. 고대 이래로, 이러한 운동에 의해서 춘분점이 양자리에서 빠져나와 인접한 물고기 자리로 들어갔다. 우리의 현재 북극성도 시간이 지날수록 변하게 된다. A.D 12000년 경에는 북극성이 거문고자리 내에 있는 밝은 별인 베가(Vega)가 될 것이다.
pre-main-sequence star|전주계열별|별의 진화에서 수소 핵융합이 일어나고 있는 주계열 별이 되기 전까지의 단계.
pressure|압력|단위 면적에 작용하는 힘.
pressure gradient|압력 기울기|어떤 방향으로 압력이 변화하는 정도.
primary|주성|쌍성계에서 더 밝은 별.
primeval fireball|원시 화구|대폭발 모형에서 대부분의 에너지가 고에너지 전자기파의 형태로 존재했던 뜨겁고 밀했던 초기 우주.
principle of equivalence|등가 원리|아인슈타인의 일반 상대론의 근본 생각. 중력에 의한 가속과 다른 종류의 가속을 구분할 수 없다. 즉, 적당히 가속되는 좌표계에서는 중력을 없앨 수 있다는 원리.
Prominences|홍염紅焰, 프로미넌스|태양의 밝은 표면 위에서, 주로 수소로 이루어진 작열하는 기체의 덩어리들. 그것들은 단지 개기 일식동안에만 맨눈으로 볼 수 있지만, 최신 장비들에 의해 언제라도 관측되어 연구될 수 있다. 홍염은 폭발형(Eruptive Type)과 정지형(Quiescent Type)의 두 가지 주요 형태가 있다.
Proper Motion|고유운동|천구 상에서 한 항성의 독립적인 운동. 항성들은 매우 멀리 떨어져 있기 때문에, 그들의 고유 운동들은 매우 미미하다. 고유운동이 가장 크다고 알려진 별은 버나드 별(Barnard's Star, 6광년의 거리에 있는 적색왜성)이다. 버나드별은 매 6년에 1´각 만큼 움직이며, 그래서 180년이 걸려야 달의 겉보기 직경(0.5˚)과 같은 양 만큼 움직인다. 멀리 떨어진 별들이 고유운동은 너무나 미미해서 전혀 측정되지 않기도 한다.
protogalaxy|원시 은하|중력 수축하여 은하가 될 수 있을 정도의 질량을 가진 구름.
Proton|양성자|단위 양전하 값을 가진 기본 입자. 수소 원자의 핵은 한 개의 양성자로 구성되어 있다.
protoplanet|원시 행성|미행성체의 집적으로 생성된 큰 질량 덩어리로 마지막 단계에 행성을 형성하게 된다.
protostar|원시별|별의 탄생과정에서 볼 수 있는, 중력 수축에 의해 붕괴되는 기체와 티끌들의 덩어리.
Pulsar|펄서|연속적으로 방출하지는 않지만, 빠르고 주기적인 펄스파를 방출하는 전파 발생원인 중성자별. 펄서들의 주기는 때때로 1초보다 적은 값을 가질 정도로 짧다.
Purkinje Effect|푸르킨제 효과|선천적인 인간의 눈에 대한 효과로, 광도의 일반적인 양이 적을 때, 더 긴파장의 빛에 대해 덜 민감하도록 만든다. 똑같은 세기를 가진, 하나는 붉은 색이고 하나는 푸른색인, 두 빛을 생각해보자. 만약 같은 정도로 두 개의 광도가 줄어든다면, 둘 중에 푸른 빛이 더 밝다고 느끼게 될 것이다.
Quadrature|현, 弦|지구에서 볼 때, 태양에 대해 직각일 때의 달이나 행성의 위치. 그러므로, 달은 절반의 위성에 보일 때 현에 있게 된다.
quantum|양자|불연속적인 에너지 묶음.
quantum number|양자수|양자론에서 원자의 에너지 구조와 양자 상태를 결정하는 네 가지 수.
quantum state|양자 상태|원자 안의 전자 배열을 기술하는 것으로 가장 낮은 에너지 준위를 가장 먼저 채워야 한다.
quark|퀴크|양성자와 중성자와 같은 입자를 구성하는, 제 3의 요소를 가진 기본 입자.
quasar or quasi-stellar-object, QSO|퀘이사 또는 준성체|가시영역의 방출 스펙트럼에 매우 큰 적색 이동이 관측되는 가시 영역 도는 전파 영역의 점광원.
Quasar(퀘이사, 준성|準星)|매우 멀리 떨어진 엄청나게 밝은 천체로, 지금은 매우 활동적인 은하의 핵인 것으로 알려져 있다. 아마도 그 내부에 있는 무거운 블랙홀에 의해 에너지를 공급받는 것 같다. 퀘이사들은 항성상 천체(QSO, Quasi-Stellar Object)라고 부르기도 한다. 도마뱀자리 BL천체(BL Lacerte Object)는, 비록 중요성이 덜하다 하지만, 같은 형태를 하고 있다.
Radar Astronomy|레이더 천문학|천체들을 연구하기 위해서 레이더 파를 이용하는 기술. 대부분의 행성들과 일부 소행성들은 레이더에 의해 포착되었으며, 레이더 장치는 마젤란(Magellan)과 같은 우주 탐사선에 실려서 우리에게 금성 표면의 자세한 지도를 얻을 수 있게 해준 것처럼 여러 천체관측에 사용되고 있다.
radar mapping|레이더지도 그리기|행성 표면에서 반사된 레이더파로부터 행성의 지형적인 특징을 밝혀 그려내는 방법.
Radial Velocity|시선 속도|속도의 성분 중에서 시선 방향의 성분. 다가오거나 멀어지는 천체의 운동이며, 그 천체의 스펙트럼 내의 도플러 효과(Doppler Effect)에 의해 측정된다. 만약 스펙트럼의 선들이 적색쪽으로 이동되었다면, 그 천체는 후퇴하고 있는 중이다. 만약 이동이 청색쪽이라면, 그 천체는 접근하고 있는 것이다. 상투적으로, 시선 속도는 멀어지는 천체에 대해 양의 값을 가지며, 접근하는 천체에 대해서는 음의 값을 가지고 있다.
radian|라디안|각측정의 단위, 1라디안은 57,3도, 2π라디안은 360도
Radiant|복사점, 방사점|어떤 특정한 유성우가 방사상으로 퍼지는 것처럼 보이게 되는 하늘의 지점. (일례로, 8월의 유성우는 페르세우스 자리 내에 그 복사점을 가지기 때문에 그 유성체들은 페르세우스 유성군(Perseids)로 부른다.) 유성우 내의 유성체들이 그리는 호는 실제적으로는 평행한 경로내에서 우주속을 지나 움직이는 것이라서, 복사점 효과는 단지 원근법 때문에 생기는 것이다.
radioactive decay|방사성 붕괴|어떤 원자가 핵분열을 일으키며 가벼운 원소로 바뀌는 것.
Radio Astronomy|전파 천문학|전자기파 스펙트럼의 장파장 영역 내에서 이루어지는 천문학적 연구들. 사용되는 주요 기기는 전파 망원경이며, 이 전파 망원경에는 많은 종류가 있다.
radio galaxy|전파 은하|엄청나게 강력한 전파 복사의 방출원인 은하. 싱크로트론 복사에 의해서 많은 양의 전파에너지를 발하는 은하로 대개의 경우 중심핵을 사이에 두고 반대 방향으로 커다란 두 개의 전파 엽이 있는 것이 보통임. 크게 밀집된 것과 확장된 것 두 가지 형태로 분류됨.
radio interferometer|전파 간섭계|두 개 이상의 안테나로부터 관측된 신호를 이용하여 높은 각분해능을 갖도록 해주는 전파 망원경.
radiometric dating|방사능 연대 측정|대상체에 포함된 동위 원소의 분석을 통해 대상체의 나이를 판별하는 것.
radio recombination line emission|전파 재결합 방출선|높은 에너지 준위에서 전자나 아온의 결합에 의해 낮은 에너지 준위로 천이되면서 방출하는 전파 영역의 방출선.
radio telescope|전파 망원경|천체로부터 전파를 관측하기 위한 망원경.
ray|방사성 띠|달과 같은 위성에서 관측되는 충돌 구덩이로부터 퍼져 나온 물질들이 만들어낸 밝은 띠
recombination|재결합|이온화의 역과정으로 이온과 전자가 결합하는 것.
reddening|적색화|작은 입자들이 파장이 짧은 푸른색을 선택적으로 산란, 흡수하기 때문에 붉은색 빛이 푸른색보다 더 멀리까지 전파되는 현상.
red giant|적색 거성|높은 광도와 낮은 표면온도(2500K 정도)를 가지는 크고 차가운 별; 별의 내부에는 여러 층에서 핵융합 반응이 일어나고 있으며 대류로 이 에너지를 외부로 전달하고 있는 것이 보통이다.
red shift|적색 이동|멀어지고 있는 천체로부터 나오는 복사가 도플러 효과에 의해서 파장이 긴 적색 쪽으로 밀려 관측되는 것. 적색편이,스펙트럼 끝부분의 적색이나 긴 파장 쪽으로 스펙트럼 선들의 도플러 효과에 의한 이동이며, 후퇴 속도를 표시한다. 국부 은하군(Local Group)내의 구성원들을 제외하고, 모든 은하들은 그들의 스펙트럼에서 적색편이를 나타낸다.
red variable|적색 변광성|변광하는 별들 중 비교적 차가운 별.
reference frame|기준 좌표계|위치나 운동이 기술되어 있는 좌표계; 또는 현상을 물리법칙으로 공식화할 수 있는 사고의 기본 틀.
reflecting telescope|반사 망원경|매끄럽게 깎은 거울에 반사한 빛을 모으는 망원경.
reflection|반사|두 매질 사이의 경계에서 빛이 되돌아오는 현상.
reflection nebula|반사 성운|먼지 입자에 의한 산란 효과로 인해 밝게 빛나는 것처럼 보이는, 기체와 먼지입자로 이루어진 구름.
refraction|굴절|공기와 유리와 같이 서로 다른 매질을 통과하여 빛이 꺾이는 현상.
refraction telescope|굴절 망원경|렌즈로 빛을 모으는 망원경.
regular cluster of galaxy|정규 은하단|잘 알아볼 수 있는 중심을 가지고 있으며, 그 내부에 은하들이 규칙적으로 분포하고 있는 은하단.
relativistic Doppler shift|상대론적 도플러 이동|특수 상대성이론에 의해서 계산된 시선 방향의 운동에 의한 도플러 이동. 아무리 큰 적색이동이라도 빛의 속도보다 큰 시선 운동 속도를 가리키진 않는다.
relativity|상대론|아인슈타인에 의해 제시된 두 이론으로 특수 상대론은 가속되지 않은 물체의 운동을 기술하는 것이고 일반 상대론은 중력 이론이다.
relativity jet|상대론적 제트|빛의 속도에 가까운 속도로 움직이는 입자들의 흐름.
Resolving Power|분해능|함께 가까이 접근하여 있는 물체들을 분리하는 망원경의 능력. 더 큰 구경의 망원경일수록, 그 분해능은 높다. 전파 망원경들은 광학 망원경에 비해 낮은 분해능을 가진다.
Retardation|지연효과|어떤 날 밤에서 다음날 밤 사이간의 월출의 시간에서의 차이. 이것은 1시간을 초과하기도 하고, 또 15분 정도의 작은 시간차일 때도 있다.
retrograde motion|역행|외행성의 경우 충 근처에서, 내행성의 경우 내합 근처에서 행성이 배경 별들을 기준으로 볼 때 서쪽으로 운동하는 것처럼 보이는 현상. 태양계 내의, 어떤 점에서 지구의 궤도 내에서 움직임에 대해 반대 방향인 운동. 일부 혜성들, 그 중에서도 특히 헬리혜성은 역행을 한다. 이 용어는 하늘에서 행성들의 겉보기 움직임에 대해서도 사용된다. 겉보기 운동이 고정된 항성들에 대해 동에서 서쪽으로 움직일때, 그 방향이 역행이다. 이 용어는 행성들의 자전에 대해서도 사용되기도 한다. 천왕성은 직각보다 많은 축 경사각을 가지기 때문에, 그 자전은 기술적으로(?) 역행이다. 금성도 역자전을 한다.
retrograde rotation|역자전|동쪽에서 서쪽으로 자전하는 운동.
Reversing Layer|역전층|태양의 밝은 표면, 즉 광구 위에 있는 기체의 층. 그 기체들은 스스로 빛나기 때문에 밝은 스펙트럼 선을 낸다. 그러나 광구가 배경으로 연결됨으로써, 그 선들은 거꾸로 바뀌어 검은 흡수선, 즉 프라운호퍼 선(Fraunhofer Lines)처럼 보이게 된다. 엄격히 이야기 하자면, 태양의 채층(Chromosphere)은 전부 다 역전층이다.
revolution|공전|한 천체가 다른 천체를 중심으로 혹은 질량중심을 중심으로 도는 것.
Ridberg constant|리드베리 상수|수소 원자의 에너지 준위의 분포와 관련된 상수.
Right Ascension|적경|한 천체의 적경은 춘분점의 남중과 관련 천체의 남중사이에 경과한 시간이다. 일례로 황소자리의 알데바란(Aldebaran, 황소자리 Α별)은 춘분점이 남중한 후 4시간 33분후에 남중한다. 그래서 알데바란의 적경은 4h 33m이다. 태양계 내의 천체들의 적경은 빠르게 변화한다. 그러나, 느리게 누적되는 세차운동(Precession)의 효과만 제외한다면, 항성들의 적경은 변하지 않는다.
Roche Limit|로시 한계|행성이나 다른 천체의 중심으로부터 2차 물체가 중력의 일그러짐에 의해 분쇄되는 이내의 있는 거리. 이것은 단지 약간의 구조적인 결합력을 가지지 않는 궤도를 도는 물체에 대해 적용되기 때문에, 튼튼하고 단단한 물체들, 즉 인공위성과 같은 물체들은 지구에 대한 로시 한계내에서도 안전하게 잘 움직일 수 있다. 로시 한계는 행성 중심으로부터 행성 반경의 2.44배의 위치에 놓여있으며, 지구에서는 지표면 위 약 9170㎞까지이다. 토성의 고리 조직은 토성에 대한 로시 한계 내에 있다.
Roche lobe|로시 로브(떡잎)|쌍성계에 있어 두 별의 중력장에 의해 한 별에서 다른 별로의 길이 연결되어 있는 영역을 둘러싼 지역.
rotation|자전|행성과 같은 천체가 자신의 축을 중심으로 도는 현상.
r-process|급속반응|베타 붕괴를 거친 핵에 빠른 속도로 중성자가 달라붙어 중원소가 합성되는 반응.
RR Lyrae stars|거문고자리 RR형 별|하루보다 짧은 주기로 변광하는 거성의 집단. 주로 구상성단에서 발견되는 종족Ⅱ형의 별들임
RR Lyrae Variable|거문고자리 RR별 형 변광성|주기가 매우 짧은(1시간~30분 정도) 규칙적인 변광성. 이들은 광도에서 상당히 균일한 것처럼 보인다. 전부 태양 광도의 90~100배 정도이다. 그래서 이들은 케페이드 변광성(Cepheid)과 같은 방식으로 거리 측정에 사용된다. 그들 중 대다수가 성단 내에서 발견되며, 이전에는 성단 케페이드(Cluster-Cepheid)라고 불렀다. 거문고자리 RR형 변광성들은 맨눈으로 볼 수 있을 만큼 충분히 밝지는 않다.
runaway accretion|급속 중력수축|주위의 다른 미행성체보다 더 큰 탈출속도를 가진 미행성체가 더 빨리 성장하는 현상.
S0 galaxy|S0은하|허블 은하 분류에서 타원 은하와 나선 은하 사이에 위치한 은하로 원반은 있지만 나선팔이 없다.
Sagittarius arm|궁수자리 팔|궁수자리 방향으로 은하 중심에서 약 2000pc떨어진 곳에 위치한 나선팔 구조.
Sagittarius A;Sgr A|궁수자리 A |은하의 중심에 있는 전파원., 서 궁수자리 A(Sgr A West)는 열적 전파원이고, 동 궁수자리 A(Sgr A East)는 비열적 전파원으로 알려져 있으며, 궁수자리 A*(Sgr A*)는 은하의 중심에 있다고 생각되며 점원으로 관측된다.
Saros|사로스 주기|태양과 지구와 달이 거의 똑같은 상대적인 위치로 돌아오는 18년 11.3일의 주기. 그래서 태양이나 달의 식(Eclipse)은 18년 11.3일 후에 유사한 식이 일어나기 쉽다. 이 주기는 정확한 것은 아니지만, 예언을 하기에는 충분하다. 때때로, 고대에 그리스의 철학자들에 의해 일식이나 월식의 예언이 이루어지기도 했었다.
Satellite|위성|주 행성의 주위를 도는 2차적인 천체. 지구는 한 개의 위성(달)을 가지고 있다. 목성은 16개, 토성도 16개, 천왕성은 15개, 해왕성과 명왕성은 한개를 가지고 있는 반면에, 수성과 금성은 가지고 있지 않다. (이 내용자체가 예전에 번역한거라.. 위성수가 차이가 날 겁니다. 현재는 목성과 토성의 위성수는 엄청나게 늘어버렸지요. 거기다 명왕성은 행성에서 왜행성으로 지위가 격하되었으니..;)
scarp|급경사|편평한 면을 가로지르는 긴 연직 방향의 벽.
Schmidt Telescope(or Schmidt Camera) |슈미트 망원경, 슈미트 카메라|구면 거울과 특수 유리로된 보정판을 사용하는 망원경의 한 형식. 이것을 사용하면, 한 번의 노출로 상대적으로 하늘의 넓은 지역이 찍혀질 수 있다. 선명도는 전체 필름에 걸쳐 좋다. 원래의 형태에서는 슈미트 망원경은 단지 사진용으로만 사용될 수 있었다. 사용중인 제일 큰 슈미트 망원경은 팔로마(Palomar)에 있는 122㎝기기이다.
Schwarzchild radius|슈바르트실트 반지름|자체 중력으로 빛을 잡아 가두기에 충분할 정도의 질량을 가지는 별의 임계 반지름.
scientific model|과학적 모형|물리학, 수학, 미학에 의해 추론되는 자연 세계에 대한 이미지.
Scintillation|신틸레이션|별들의 반짝거림. 이것은 전적으로 지구 대기에 의해 생기는 효과이다. 별은 수평선 위에 낮게 떠 있을 때 그 빛이 대기의 두꺼운 층을 통과하기 때문에 가장 심하게 반짝거리게 된다. 행성은 점이라기 보다는 작은 원반 형태로 나타나므로 별보다는 훨씬 덜 반짝거린다.
secondary|반성|쌍성계의 두 별 중 더 흐릿하게 관측되는 별.
second dredge-up|두 번째 준설(끌어올림) |질량이 큰 별이 적색거성으로 되면서 헬륨원소의 산물이 대류에 의해 별표면으로 올라오는 현상.
 second of arc|초|1/3600도, 1/60분.
Second Of Arc|초각|1˚의 360분의 1.
Secular Acceleration(장세|長歲) 가속|조석력(潮汐力)때문에 발생하는 마찰때문에 지구의 자전이 점점 느려지는 현상. "하루"는 점점 길어지게 된다. 평균 하루 길어짐은 단지 0.00000002초이지만, 충분히 긴 기간이 지나면 이 효과는 감지할 수 있게 된다. 지구의 시간기간의 길어짐은 태양, 달, 행성의 겉보기 속력 증가를 일으키게 한다. 이러한 조석 현상의 또 다른 결과는 달이 지구로부터 멀어지게 되는 것이다.
secular parallax|고유 시차|태양의 직선운동에 대한 별의 고유운동을 관측하여 어떤 별 집단까지 평균거리를 측정하는 방법.
seeing|시상|망원경의 상을 불규칙하게 만드는 지구대기의 불안정도. 별의 영상의 고정됨과 투명도의 질. 이것은 지구대기에서의 환경에 의존한다. 달 또는 우주에서의 "시상"은 언제나 완벽하다.
seismic wave|지진파|지진에 의해 형성되어 지구 내부를 전파해 온 파동.
seismometer|지진계|지구나 달의 지진을 측정하기 위한 측기. 지진 기록장치. 아폴로 우주인에 의해 매우 민감한 지진계들이 달로 운반되었으며, 그곳의 지진환경에 대한 흥미로운 정보를 제공해 주었다.
Selenography|월리학, 月理學|달 표면에 대한 학문.
semimajor axis|긴반지름|타원의 장축 반지름, 타원의 중심에서 가장 먼 점까지의 거리
sexagesimal system|60진법 계|60을 기준으로 사용하는 계수 방법, 예를 들면 60초는 1분, 60분은 1도.
Sextant|육분의, 六分儀|지평선 위의 천체의 고도를 측정하기 위해 사용되는 기구.
Seyfert Galaxies|시퍼트 은하|작고, 밝은 핵을 가지는 은하들. 그들 중 대부분이 전파 발생원이며, 그들의 핵 안에서 격렬한 동요의 증거들을 보여주고 있다.
Seyfert galaxy|세페이트 은하|활동 은하핵 은하로서 주은하는 대부분 나선 은하이다. Ⅱ형의 경우 핵 부근에서 스펙트럼에 매우 좁고 강한 방출선이 관측되며, Ⅰ형의 경우에는 좁거나 넓고 강한 방출선이 함께 관측된다.
shepherd satellite|목자 위성|행성 고리의 좁은 틈 사이에 갇혀있는 위성들로서 하나는 고리의 바깥쪽 경계에 있고 다른 하나는 안쪽 경계에 있다.
shield volcano|순상화산|마그마가 천천히 분출해서 생성된 경사가 원만한 화산.
shirt period comets|단주기 혜성|긴 주기를 가진 혜성들 중에서 커다란 행성에 의해 붙잡혀 200년보다 짧은 주기를 갖게 된 혜성들.
shock wave|충격파|어떤 물체가 음속보다 빠른 속도로 운동할 때 주위의 매질에 형성되는 불연속 경계.
Sideral Month |항성월恒星月|달이 별들에 대해서 중심(重心, Barycenter)주위로 완전히 한바퀴 도는데 걸리는 시간.
Sideral Period|항성주기|행성이나 다른 천체가 태양의 주위를 한바퀴 도는데 걸리는 시간. (지구의 경우에는 365.2일이다.) 이 용어는 행성 주위의 궤도 내에 있는 위성에 대해서도 사용된다. 또한 이 용어는 Periodic Time이라고 알려져 있다.
Sideral Time|항성 시간|천구의 겉보기 자전에 따라 계산된 지역시. 춘분점이 관측자의 자오선을 지날 때가 0시이다. 어떤 관측자에게라도 항성시는 그때 자오선 상에 놓여있는 천체의 적경과 같다. 그리니치 항성시가 세계 표준시로 사용되고 있다. (이것은, 물론, 단지 그리니치 천문대에서의 지역 항성시이다.)
Sidereal Year |항성년|지구의 실제 공전 주기. 365일 6시간 9분 10초이다.
silicate|규산염|지구 표면에서 가장 흔하게 관측되는 규소와 산소, 그리고 다른 원소들의 혼합물.
slow process s-process|느린 과정|베타 붕괴에 의해 만들어진 핵에 중성자가 천천히 달라 붙어 중원소가 형성되는 과정.
Small Magellanic Cloud, SMC|소마젤란운|우리 은하의 두 개의 동반 은하 중에서 더 작은 쪽, 태양 질량의 2*109배를 가진 불규칙은하이다.
Solar Apex(태양 향점|向點)|외관상으로 태양이 움직이고 있는 쪽으로 천구 위의 점. 이것은 헤르쿨레스 자리 내에 있다. 향점으로의 태양이 움직이는 속도는 19㎞/S이다. 하늘에서 태양향점에 정확히 반대되는 지점은 태양 반향점(Solar Antapex)이라 부른다. 향점으로의 태양의 운동은, 대략 320㎞/S의 양으로 은하 중심주위를 도는 태양의 회전과는 다른 것이다.
Solar Constant|태양 상수|태양 복사에 의해 지구 표면상에 수용되는 에너지의 총량을 측정하기 위한 단위이다. 이것은 1.94 ㎈/분/㎠과 같다.
solar eclipse|일식|달이 태양의 앞을 지나갈 때 달의 그림자 속으로 태양이 들어가는 현상. 언제나 달의 위상이 삭일 때 관측됨. 달이 태양의 정면을 지나가는 것에 의해 발생한다. 우연하게도, 달과 태양은 시직경이 거의 같다(0.5도). 배열이 정확하게 된다면, 달은 전체적 또는 부분적으로 짧은 동안이지만 태양의 밝은 표면을 가리게 된다. 식이 개기식일 때에는 태양을 둘러싸고 있는 채층(Chromosphere), 코로나(Corona), 홍염(Prominence)등이 맨눈으로 보인다. 만약 태양이 완전히 가려지지 않으면, 식은 부분식(Partial Eclipse)이 되며, 개기 일식에서의 멋진 현상들은 볼 수가 없다. 만약 달이 지구에서 가장 먼 거리 근처에 있다면(원지점(Apogee)참고), 달은 태양보다 약간 더 작아 보이게 될 것이며, 그래서 태양을 완전히 가리지 못하고 태양의 바깥쪽에 고리모양처럼 태양이 남게 될 것이다. 이것이 금환식(Annular Eclipse)이다. 금환식일 때에도 역시 개기식의 현상들은 보이지 않는다.
Solar Parallex|태양 시차|태양의 삼각 시차. 이것은 8.79˝각과 같다.
Solar Time, Apparent(시|視) 태양시|태양에 의거하여 계산된 지역시. 정오는 태양이 관측자의 자오선을 지날 때 발생하며, 태양이 하늘에 가장 높이 떠 있을 때이다.
Solar Wind|태양풍|태양으로부터 모든 방향으로 뿜어져 나오는 원자나 입자들의 고정적인 흐름. 이것은 우주 탐사선 덕택에 감지할 수가 있었으며, 우주 탐사선의 대부분이 이것을 연구하기 위한 기기들을 싣고 있다. 이것의 속도는 지구 근처에서 965㎞/Sec를 초과한다. 태양폭풍(Solar Storm)동안에는 태양풍의 세기가 높아지게 된다.
Solstices|지, 至|태양이 하늘에서 최북 지점(적위 23˚N, 6월 22일경)이거나 최남 지점(적위 23˚S, 12월 22일경)에 있을 때. 지의 날짜는 매우 어중간한데, 그것은 윤년에 의해 생기는 달력의 불규칙성 때문이다.
south magnetic pole|남자극점|별이나 행성에서 자기의 북극에서 뻗어나온 자기력선이 모여 들어가는 지점.
space|공간|물체들이 운동하고 어떤 사건들이 일어나는 3차원적인 지역.
spacetime|시공간|3개의 공간축과 1개의 시간축으로 이루어져 어떤 사건에 대한 시간과 공간을 하나로 기술하는 계.
spacetime curvature|시공간의 휘어짐|질량이나 에너지에 의해 시공간이 굽어지는 현상.
spacetime diagram|시공간 다이어그램|하나의 공간축과 하나의 시간축으로 이루어진 다이어그램으로 시간과 세계선 사이의 관계를 나타내는데 이용됨.
space velocity|공간 속도|시선 방향의 속도와 접선 속도를 합친 물체의 총 속도.
Spectroheliograph|단광 태양사진기|하나의 특정한 파장의 빛으로만 태양을 찍기 위해 사용되는 기기. 만약 볼 수 있도록 바꾸어서 사용한다면, 그것은 단광 태양 망원경이라고 한다.
Spectroscope|분광기|별이나 다른 발광체들 상의 빛을 분석하기 위해 사용되는 기구. 천체 분광기(Astronopmical Spectroscope)는 망원경과 함께 사용된다. 이것들이 없었다면 우주의 성질에 대한 우리의 지식은 여전히 매우 초보적이었을 것이다.
Spectroscopic Binary|분광 쌍성|구성원들이 서로 너무 접근해 있어서 불리해서 볼 수는 없지만, 그들의 상대 운동 때문에 분광학적으로 감지할 수 있는 서로 반대되는 도플러 이동(Doppler Shift)를 발생시키는 쌍성.
spectrum|스펙트럼|프리즘을 통과시키는 등의 방법으로 빛을 분산시켰을 때 얻어지는 파장별 빛의 배열. 어떤 물체에 의해서 각 파장 영역별로 방출되는 에너지량의 총합을 가리킨다.
Spherical Aberration|구면 수차|망원경상의 영상이 흐릿하게 되는 원인으로, 반사경이나 렌즈가 그 가장자리와 중앙에 있는 서로 떨어진 빛줄기를 정확히 같은 초점에 못 모이게 하기 때문에 발생한다. 만약 구면 수차가 현저하다면, 거울이나 렌즈의 질이 나쁘다고 봐야하며, 보정할 필요가 있다.
spherical closed  geometry|구면 기하학 |유클리드 기하학의 대안으로 리만(Rimann, G.F.B.)이 제시한 기하학. 직선상의 한 점을 지나는 평행선은 존재하지 않는다는 가정을 기초로 함. 구면에 그려진 삼각형의 세 내각의 합은 180°보다 항상 크다
spicules|스피큘|태양의 광구에서 채층 쪽으로 뻗어있는 창 모양의 뜨거운 기체. 태양의 채층에서 최고 16,000km까지의 분출현상. 각각의 스피큘은 4~5분정도 지속된다.
spin angular momentum|스핀 각운동량|회전하는 물체의 각운동량. 물체의 질량분포, 회전 속도, 반지름과 관련되어 있다.
spiral arm|나선팔|기체와 티끌입자, 그리고 젊은 별들로 구성된 은하의 나선 모양 구조, 은하 중심 근방에서부터 휘감겨 나오는 것으로 보인다.
spiral galaxy|나선 은하|우리 은하와 같이 나선팔을 가지고 있다고 생각되는 은하.
spiral nebula|나선 성운|망원경으로 처음 나선은하를 관측했을 때 붙여진 이름.
spiral tracer|나선팔 추적 천체|나선팔에서 흔히 관측할 수 있는 천체들. 예를 들면 종족 Ⅰ세페이트, HⅡ지역, OB별 등을 들 수 있다.
sporadic meteors|산발 유성|유성우와 관계없이 불규칙적으로 떨어지는 유성.
stadium|스타디움|고대 그리스의 길이 단위, 대략 0.2km정도.
steady-state model|정상 우주 모형|우주는 어떤 시각에서 어떤 관측자에 의해 관측되는지 간에 똑같이 보인다는 완전 우주론적 원리(perfect cosmological principle)에 기초한 우주론.
Steady-State Theory|정상우주론|우주는 항상 존재해 왔고 또 영원히 존재할 것이라는 이론. 이 이론은 현재 거의 모든 천문학자들에 의해 기각되었다.
Stefan-Boltzmann"s law|슈테판-볼츠만의 법칙|흑체가 단위 면적당 방출하는 에너지와 온도와의 관계를 나타내는 법칙.
stimulated emission|유도 천이 방출|들뜬 상태에 있는 원자가 어떤 에너지(파장)를 가진 광자에 의해 그 광자의 파장과 같은 파장의 광자를 방출하도록 유도되어 생기는 복사.
stony-iron meteorites|석철질 운석|니켈-철과 규화물이 혼합된 운석.
stony meteorites|석질 운석|주로 규화물로 이루어진 운석.
straight line|직선|두 점 사이의 가장 짧은 거리.
stratosphere|성층권|고도가 커질수록 온도가 감소하고 구름이 없어지는 특성을 보이는 지구 대기의 층.
Stratosphere|성층권|대류권(Troposphere) 위에 놓여있는 층. 이것은 해발 11㎞~64㎞ 정도에 걸쳐있다.
strong nuclear force|강한 핵력|자연계에 존재하는 네 가지 힘 중의 하나. 두 원자핵이 매우 짧은 거리를 두고 함께 존재할 때 작용함.
S-type asteroid|S형 소행성|규산염으로 이루어졌다고 생각되는 정도의 반사도를 가진 소행성.
Sundial|해시계|기울어진 해시계의 바늘(Gnomon)을 이용해서 눈금이 있는 숫자판 위에 그림자를 투영하는 것에 의해 시간을 나타내는 기기. 해시계는 진태양시(眞太陽時)를 나타내게 된다. 평균 태양시를 구하려면, 숫자판 위에 나타난 값을 균시차(Equation Of Time)를 사용해서 보정해야 한다.
Sunspot|흑점|태양 광구상의 어두운 반점. 이것들의 온도는 대략 4000℃여서 (광구의 표면온도가 6000℃라는 것과 대비되어) 단지 대조적으로 어둡게 보일 뿐이다. 큰 흑점은, 더 밝은 지역인 반암부(Penumbra)에 둘러싸인 중앙의 어두운 지역인 암부(Umbra)로 구성되어 있으며, 크고 불규칙적인 형태를 가진다. 흑점들은 무리를 지어 나타나는 경향이 있으며, 강력한 자기장과 연결되어 있다. 그들은 또한 백반들(Faculae)과 태양면 폭발 플레어(Flare)와 관련이 있기도 하다. 이것들은 (대략 11년 주기로 찾아오는) 태양 극대기의 시기에 가장 자주 발생한다. 어떤 흑점도 기껏해서 몇달 이상은 지속되지 않는다.
supercluster|초은하단|여러 개의 은하단이 하나로 묶여진 커다란 계.
supergiant|초거성|매우 큰 광도와 크기를 가지는 무거운 별.
supergiant elliptic cD galaxy|초거대 타원은하 |주로 은하단의 중심부에서 관측되는 가장 크고 무거운 타원 은하. 하나 이상의 핵을 가지는 경우가 많다.
supergravity|초중력|우주의 첫 10-43초 동안의 역사를 기술하기 위해 중력과 양자론적 사고를 결합시킨 모형.
superior conjunction|외합|내행성은 태양과 같은 방향에, 외행성은 태양의 반대편에 위치하게 되는 천체의 배열.
Superior Conjunction|외합|지구에서 보았을 때, 태양의 건너편 쪽에 있을 때의 행성의 위치.
superluminal motion|초광속 운동|빛의 속도보다 빠른 속도로 움직이는 겉보기 운동.
supermassive black hole|초질량 블랙홀|태양 질량의 106배 이상의 질량을 가지는 블랙홀.
supernova|초신성 폭발|무거운 별이 진화의 마지막 단계에서 폭발하면서 며칠 동안 광도가 10억 배 이상 커질 정도의 엄청난 에너지를 방출하는 천문학적 현상. 엄청난 별의 폭발현상. 초신성 I형은 함께 쌍성을 형성하고 있던 백색왜성의 완전한 파괴를 일으킨다. 초신성 II형은 매우 무거운 별의 붕괴에 의해 생겨난다. 초신성의 폭발 절정시에는, 보통 은하의 모든 다른 별들의 광도를 합한 양보다 초과하는 광도를 내기도 한다.
supernova remnant|초신성 잔해|초신성 폭발의 결과로 별의 바깥 껍질이 불려나간 성운으로, 매우 빠른 속도로 팽창하는 기체 구름. 주로 전파 영역에서 관측됨.
superwind|초항성풍|매우 강한 항성풍.
synchrotron radiation|싱크로트론 복사|전하를 띤 입자(주로 전자)가 강한 자기장 내에서 가속될 때 방출되는 복사. 방출되는 복사의 파장은 자기장의 세기와 전자가 가지고 있는 에너지에 의해서 결정됨.
Synchrotron Radiation|싱크로트론 복사|대전된 입자가 강력한 자기장 내에서 상대론적인 속도로 움직이는 것에 의해 방출되는 복사현상. 게 성운(Crab Nebula)으로부터 오는 전파 복사의 대부분이 싱크로트론 복사에 의한 것이다.
synodic month|삭망월|만월에서 다음 만월까지 걸리는 시간처럼 달과 태양의 위치가 다시 비슷해질 때 까지 걸리는 시간.
Synodic Period|상합주기|외행성의 충 사이의 간격. 내행성에 대해서는 합 사이의 간격을 의미하기 위해 사용된다.
Syzygy|삭망, 朔望|신월이나 보름일 때 궤도 내의 달의 위치.
Tektites|텍타이트|공기 역학적으로 형성된 것으로 보이는 작고, 유리질의 물체로, 두 번 이상 가열되어서 만들어진 것으로 보이는 물체. 이것들이 운석이라고 주장되어 왔지만, 지금은 일반적으로 이것들이 지질학적인 원인에 의해 생긴 것이라고 믿어지고 있다.
Telemetry|원격 측정법|기기상으로 이루어진 측정과 관측의 결과들을 접근하기 어려운 곳 (궤도 내의 무인 탐사선 같은 곳)에서 그 결과들을 사용하고 분석할 수 있는 지점으로 전송하는 기술.
temperature|온도|어떤 물질을 이루는 미세 입자들의 평균 불규칙 운동을 나타내는 척도.
temperature gradient|온도 기울기|단위 거리를 이동하는 동안에 생기는 온도의 변화.
Terminator|명암경계선|달이나 행성의 낮과 밤사이의 경계선 부분. 달의 표면은 산이 많기 때문에 명암경계선은 거칠고 들쭉날쭉하며, 독립된 산봉우리는 심지어 달의 본체에서 떨어져 나온 것처럼 보인다. 수성과 금성은, 역시 달의 형태와 같은 위상을 나타내지만, 거의 평탄한 명암경계선을 가지는데, 이것은 우리가 그 표면을 지구에서 자세하게 볼 수 없기 때문일 것이다. (실제로, 최소한 수성의 경우에는, 그 표면이 달의 표면만큼 산이 많은 지형이다.) 화성은 비록 지금은 그 표면이 조금도 평탄하지 않다는 것이 알려졌지만, 평탄한 명암경계선을 보여주고 있다. 우주나 달에서 찍힌 지구의 사진에서, 대기의 존재 때문에, 지구의 명암경계선은 달보다 훨씬 "부드럽게" 보이며, 평탄한 형태를 지니고 있다.
terrestrial planet|지구형 행성|화성, 수성, 금성 달처럼 지구와 크기가 같거나 조성이 비슷한 행성들.
thermal equilibrium|열적 평형|큰 규모에서 온도 변화가 없는 정적인 상태.
thermal pulses|열적 펄스|적색 거성의 껍질부에서 삼중 알파 반응에 의해 갑자기 많은 양의 에너지가 방출되는 현상.
thermal radiation|열복사|물체의 온도 때문에 전자기파를 방출하는 현상; 흑체 복사 스펙트럼으로 나타남.
thermal speed|열속도|기체 중의 입자들이 나타내는 불규칙 운동의 평균 속도.
Thermocouple|열전쌍, 열전지|열의 매우 적은 양을 측정하기 위해 사용되는 기기. 대구경 망원경과 함께 사용되면, 대단히 미약한 열 발생원도 감지할 수 있다.
thermosphere|열권|지구의 대기권 중에서 X선과 자외선에 의해 가열되며, 중간권보다 고도가 높은 층.
three-degree cosmic blackbody microwave radiation|3중 알파반응|세 개의 알파입자가 핵융합을 일으켜 탄소로 변화하는 반응.
three-degree cosmic blackbody microwave radiation|3K 우주 배경 복사 |대폭발의 잔해로서 3K정도의 흑체 복사 스펙트럼을 나타내는 복사.
threshold temperature|임계 온도|광자가 물질과 반물질을 만들어 낼 수 있을 어떤 온도.
tidal force|기조력|두 질량체 사이에 중력이 작용할 때 한 족에서 받게 되는 위치에 따른 차등중력, 그 질량체는 차등 중력만큼 변형을 받게 된다.
Tides|조석, 潮汐|달과 (적은 정도의 영향을 가진) 태양의 중력의 끌어당기는 힘 때문에 발생하는 바닷물의 주기적인 오르내림.
Time Dilation Effect|시간 지연 효과|상대성 이론에 따르면, 운동 중인 두 관측자에 의해 경험되는 "시간"은 서로에 대해 비교될 때, 같지 않을 수 있다. 빛의 속도에 근접하게 관측자가 움직인다면, 시간은 점점 느려지게 될 것이고, 질량도 늘어나게 되어서 결국 광속도에 도달한다면, 시간은 정지하고 질량은 무한대가 될 것이다. 이런 시간과 질량 효과는 매우 높은 속도일 때를 제외하고는 전적으로 무시해도 좋을 만큼 미미하며, 현대 로켓의 속력으로도 이런 효과는 무시될 정도로 작다.
toroidal magnetic field|적도 평행 자기장|적도와 나란하게 자기력선이 배열되어 있는 자기장.
Transfer Orbit 또는 Hohmann Orbit|전이 궤도, 호먼 궤도|다른 행성으로 보내어지는 우주선에 대한 가장 경제적인 궤도. 가능한 가장 짧은 길을 따라서 여행한다는 것은 연료의 계속적인 소비를 의미하며, 이것은 실제로 불가능하다. 그래서 다른 행성과 조우하기 위한 일종의 타원궤도로 우주선을 보내는 것이 가장 안전한 방법으로 그런 궤도를 전이 궤도나 호먼 궤도라고 부른다. 이 궤도로 우주선을 보내면 자유낙하처럼 거의 연료소모 없이 행성까지 관성의 힘으로만 가는 것이 가능하다. 하지만, 그만큼 거리가 늘어나기 때문에 걸리는 시간은 증가하게 된다.
Transit|시야 통과|수성과 금성이 내합 시에 태양의 원반상에 대해 보이게 될 경우, 즉 태양과 지구 사이를 지나가게 되는 경우를 시야통과 (또는 일면통과)라고 한다. 수성의 일면 통과는 매우 빈번하지만 (일례로, 1973년 다음에 1986년에 일어났었다.), 금성의 일면통과는 현재 2004년까지 일어나지 않는다. (금성의 지난번 일면 통과는 1882년에 일어났었다.) 마찬가지로, 한 행성의 위성이 그 행성의 원반상에 대해 보이게 되는 경우에도 시야통과라고 불린다. 목성의 4대 위성의 시야 통과는 소구경 망원경으로도 볼 수 있다. 또한 이런 위성들의 시야 통과시에 그림자가 보이는 경우도 있는데 (영(影)현상) 이때는 위성에 의해 투영된 그림자들이 목성 표면상에 검은 점처럼 보인다.
Transit Instrument|자오의, 子午儀|특별하게 설치된 망원경. 이것은 고도방향으로만 움직일 수 있으며, 항상 자오선을 가리키고 있다. 이것의 유일한 사용목적은 별이 자오선을 지나는 순간을 측정하여 시간을 조사하는 방법을 제공하는 것이다. 19세기에 조지 에어리(George Airy)경에 의해 그리니치 천문대에 설립된 자오의는 지구의 본초 자오선(경도 0˚)을 표시하는데 사용되고 있다. 비록 아직 널리 사용 중이지만 오래지 않아서 쓸모없게 될 것 같다.
transition in atom|원자의 천이|원자 구조에 있어 전자 위치의 재배치, 에너지 변화를 야기함.
transition region|전이 지역|태양 대기 중에서 채층과 코로나 사이에서 온도 변화가 심한 지역.
transverse velocity|접선 속도|물체의 이동 속도 성분 중 시선 방향과 직각 방향의 성분.
Trapezium cluster|사다리꼴 성단|오리온 성운에 위치한 젊고 무거운 별들로 이루어진 성단.
trigonometric parallax|삼각시차|길이를 알고 있는 기선의 양 끝에서 천체의 각위치를 측정함으로써 그 천체까지 거리를 측정하는 방법.
Trojans|트로이군 소행성|목성의 궤도 내에서 태양의 주위를 돌고 있는 소행성들. 트로이 소행성의 한 무리는 목성의 태양에 대한 60˚앞쪽에 있고, 또 다른 무리는 같은 각만큼 뒤쪽에 있어서, 충돌의 위험은 없다. 한 다스 이상의 트로이 군 소행성들이 현재 알려져 있다.
Tropical Year |태양년|태양이 춘분점을 가로지르고 그 다음에 다시 춘분점을 가로지를 때 까지의 시간간격. 이것은 365일 5시간 48분 45초로, 춘분점의 위치를 이동시키는 세차운동의 영향때문에 항성년보다 20분정도 짧아지게 된다.
tropopause|대류권계면|지구의 대기권에서 대류권과 성층권의 경계부.
troposphere|대류권|지구에서 대부분의 기상현상이 일어나는 지표에서 고도 10km까지의 대기권. 지구 대기의 가장 아래쪽 부분으로 해발 11㎞정도까지의 높이에 있는 층. 이곳은 대기 질량의 대부분을 포함하고 있다. 그리고 대기현상의 대부분이 여기서 일어난다. 대류권 위에는, 대류권과 성층권을 분리하는, 대류권계면(大流圈界面, Tropopause)이 있다.
turbulence|난류|불규칙적이고 격렬한 대류 운동.
turbulent viscosity|난류점성|어떤 기체 혹은 유체 내에서 어느 한 부분의 난류가 다른 부분의 흐름에 영향을 미치게 되는 특성; 태양계 성운에서 각운동량이 전파되는 기작을 설명하는데 중요한 역할을 함.
turn-off point|전향점|성단에 대해 작성한 H-R도에서 주계열을 떠나는 큰 광도쪽의 위치.
Twilight, Astronomical|천문박명|태양이 지평선 아래 18˚이하의 지점에 있어서, 태양이 떠 있는 상태는 아니지만 하늘이 밝은 상태
two-sphere universe|이중 구형 구조 우주|우주는 지구와 천구라는 같은 중심을 가진 구로 이루어졌다는 가정에서 출발한 우주론.
type Ⅰ, typeⅡsuper nova|종족Ⅰ, 종족Ⅱ 초신성|초신성을 광도 곡선과 스펙트럼으로 분류한 것. 종족Ⅰ은 날카로운 피크를 보이고 천천히 광도가 줄어들며 수소선이 관측되지 않지만, 종족 Ⅱ는 좀더 넓은 피크를 보이고 100일 정도 후에는 급격히 광도가 줄어들며 강한 수소선을 보여 주는 특징을 가진다.
Ultra-Violet Radiation|자외선 복사|보라색의 빛보다 더 짧은 파장을 가지는 전자기 복사여서 맨눈으로는 보이지 않는다. 전자기파 스펙트럼의 자외선 영역은 가시광선과 X선의 영역 사이에 있다. 태양은 매우 강력한 자외선 발생원이지만, 이 복사선의 대부분이 지구 상층 대기의 오존에 의해 차단된다. 그래서 항성들에서 나오는 자외선들을 연구하려면 로켓이나 인공위성에 의해서만 이루어진다.
Umbra1|암부|흑점의 어두운 안쪽 부분.
Umbra2|본영부本影部|행성이나 달에 의해 투영된 그림자의 중심부의 원추형에 해당하는 부분.
uniformity of universe|우주의 동질성|같은 성질을 가진 천체는 우주의 어디서나 같은 성질로 나타난다는 것.
Universal Time|UT, 우주시|그리니치 표준시(Greenwich Mean Time, GMT)의 다른 말
universe|우주|과거와, 현재 그리고 미래를 모두 포함한 시,공간.
university of physical laws|물리 법칙의 일관성|어떤 지역에서 만족되는 물리 법칙은 우주 전체에서도 역시 만족된다는 원리.
upland plateaus|고지의 고원|금성 표면의 커다란 고지대.
Valles Marineris|마리네리스 협곡|화성의 적도 부근에 있는 매우 깊은 협곡.
Van Allen Zone,Van Allen Belts |밴 앨런 구역, 밴 앨런 대|전기적으로 대전된 입자들이 지구 자기장에 의해 갇히고 가속되는 지구 주위의 구역. 이것들은 미국의 최초의 인공위성인 익스플로러 1호에 의해 측정된 결과를 이용해 1958년에 J. 밴 앨런과 그의 동료들이 그 존재를 증명하였다. 외관상으로 거기에는 두 개의 주요 대(帶)가 있다. 바깥쪽의 것은, 주로 전자들로 이루어져 있으며, 아주 자주 변하는데, 왜냐하면 태양에서 발생하는 일에 의해 강력한 영향을 받기 때문이다. 안쪽 구역은 주로 양성자들로 구성되어 있으며, 더욱 안정적이다.
Variable Stars|변광성|짧은 기간에 걸쳐 밝기가 오르내리는 별들.
Variation|변차, 變差|달에 미치는 태양의 인력이 그 힘에서 달의 궤도에 걸쳐 일정하지 않다는 사실때문에 발생하는 달의 움직임에서의 균차(均差, Inequality)
velocity dispersion|속도 분산|은하나 성단과 같은 천체 집단의 구성원들이 가지는 운동 속도가 평균 속도 주위에 얼마나 퍼져있는가를 나타내는 양.
vernal equinox|춘분점|봄철의 분점.
Very Large Array;VLA|장기선 간섭계 |27개의 안테나를 Y자 모양으로 배열해 만든 하나의 거대한 전파 간섭계.
Very Large Baseline Array, VLBA|초장기선 간섭계|뉴멕시코에 본부를 두고 미국 전역에 설치한 안테나들로 하나의 거대한 전파 간섭계를 만든 시스템.
virgo cluster of galaxies|처녀자리 은하단|처녀자리 쪽에 있는 가장 가까운 큰 은하.
visual binary|안시 쌍성|광학 관측으로 공통 질량중심으로 도는 두 별이 구별되는 쌍성계.
visual luminosity|광학 광도|천체가 복사하는 전자기 스펙트럼 중에서 광학 영역에 해당하는 복사속.
Vulcan|발칸, 불칸, 불카누스|한때 수성보다 안쪽에서 태양의 주위를 돌고 있었던 것으로 생각되었던 가상의 행성에 붙여졌던 이름. 현재는 불칸이 존재하지 않음이 확실해졌다. 불칸은 수성의 근일점 이동현상을 설명하기 위해 설정된 행성이였지만, 수성의 근일점 이동은 태양에 의한 공간의 휘어짐에 의해 생긴 현상이였음이 상대성이론으로 밝혀지기 때문이다.
weak nuclear force|약한 핵력|방사능 붕괴에 의해 작용하여 경입자를 지배하는 근거리 힘.
weightlessness|무중력|겉보기 무게가 0이 되는 상태; 중력장에서는 자유 낙하하는 경우에 무중력 상태에 놓일 수 있다. 일반 상대론에 다르면 무중력 상태의 운동은 시공간상에서 직선으로 나타난다.
White Dwarf|백색왜성|매우 작고, 엄청나게 밀도가 높은 별. 이 별 내부의 원자들은 산산히 분쇄되어 각각의 성분들은 거의 여분의 공간이 없을 정도로 빽빽히 채워져 있어 밀도는 물의 수백만배 정도가 된다. 백색왜성의 한 숟갈정도의 물질은 수 톤의 무게가 나갈 것이다. 분명히 백색왜성은 자신의 핵"연료"를 모두 소모해버렸다. 이 별은 자신의 활동적인 생애의 마지막 단계에 있으며, 적절하게 파산한 별(Bankrupt Star)라고 묘사되기도 한다. 중성자 별은 백색왜성보다 더 작고 밀도가 높은 별이다.
Widmanstatten Patterns|비트만스타텐 형태|만약 철 운석을 자르고 그 면을 닦은 후에 산으로 부식시키면, 철 결정의 특징적인 형태가 나타난다. 이것들이 비트만스타텐 형태로 알려져 있다. 이 형태는 운석내에서 말고는 절대로 발견되지 않았다.
Wolf-Rayet Stars|울프-라이에트 별|스펙트럼이 일반적으로 어두운 흡수선 뿐만 아니라, 밝은 방출선까지도 포함하고 있는 예외적으로 뜨겁고 녹색을 띈 흰색의 별들. 그들의 표면 온도는 100000℃까지 이르며, 그 별들은 빠르게 팽창하는 가스의 껍질에 의해 둘러싸인 것처럼 보인다. 이런 종류의 별들의 이름은 1867년에 이 별들에 주목을 한 천문학자 울프와 라이에트의 이름을 딴 것이다. 최근에는 울프-라이에트 별들이 거의 분광쌍성인 것이 발견되고 있다.
worldline|세계선|시 공간에서의 연속적인 사건의 흐름.
W virginis stars|처녀자리 W형 별|종족 Ⅱ세페이드에 속하는 맥동 변광성.
X-Ray Astronomy|X선 천문학|X선은 0.1~100Å(옹스트롬)의 파장을 가지는 매우 짧은 전자기 복사선이다. 우주로부터 오는 X선은 지구의 대기에 의해 막혀 없어지기 때문에, 인공위성에 의해 탐사해야만 조사가 가능하다. 태양 역시 X선 발생원의 하나이며, X선 복사의 세기는 태양 플레어에 의해 매우 높아지는 경우도 있다. 태양계 바깥쪽의 X선 발생원은 미국 천문학자에 의해 최초로 발견되었는데, 하나는 전갈자리에서 나머지 하나는 황소자리에서 발견을 했다. 황소자리에서 발생되는 X선이 게 성운에서 나오는 것으로 생각되고 있다. 그 후로 다양한 X선 발생원들이 발견되어 왔으며, 그들 중 일부는 변광성이다. 그리고 그들 중 일부는 블랙홀의 존재를 나타낸다고 생각되는 것도 있다.
X-ray burster|X선 폭발체|짧은 시간에 엄청난 양의 X선 복사를 방출하는 X선 전파원; 주로 쌍성계에서 중성자 별에 집속이 일어나면서 많은 양의 X선이 방출됨.
X-ray|X선|파장이 10-10m 보다 짧은 고에너지 복사.
Year|해, 연年|지구가 태양의 주위를 한번 도는데 걸리는 시간. 일상생활에서는 365일(윤년에는 366일)을 1년으로 잡고 있다. 하지만, 그 기준에 따라 다음과 같은 4가지의 해가 생긴다.
young PopulationⅠstar|젊은 종족 Ⅰ형 별|나선 은하의 원반이나 나선 팔에서 주로 발견되는 태양 정도의 금속 원소 함량을 가진 젊은 별.
ZAMS|영년 주계열(zero-age main sequence|전주계열 단계에서 주계열로 넘어 오게 되는 시점. H-R도에서 원시별이 자신의 대부분의 에너지가 중력 에너지 대신에 수소의 핵융합에 의한 핵 에너지로 대치되는 순간의 위치를 의미한다.
zenith|천정|관측자의 지평선으로부터 90° 떨어져 있는 점들이 이루는 천구상의 대원.
Zenith Distance|천정거리|관측자의 천정에서 천체까지의 각 거리.
Zenith|천정, 天頂|천구상에 투영한 관측자의 머리 위의 지점(고도 90˚)
Zodiac|황도대|황도의 양쪽으로 8˚씩, 총 16˚의 넓이를 가지는 대로, 이 안에서 태양, 달, 밝은 행성들이 발견되기 쉽다. 이것은 13개의 별자리를 통과하는데 일반적으로 황도궁으로 알려진 12개의 별자리와 땅꾼자리를 지나간다.
Zodiacal Light|황도광|지평선에서 황도를 따라서 뻗어 올라오는 빛의 원추형태. 이것은 태양이 지평선 아래 약간의 거리에 있을 때만 보이며, 깨끗하고 달이 없는 저녁이나, 아침에 가장 잘 보인다. 이것은 태양계의 중심평면 근처에 흩어져 있는 자그만 입자들 때문에 발생한다고 생각되고 있다.
Zodiac Constellation|황도 12궁|점성학(Astrology)에서 사용되는 12개의 별자리들. 1궁부터 백양궁(양자리), 금우궁(황소자리), 음양궁(쌍동이자리), 거해궁(게자리), 사자궁(사자자리), 처녀궁(처녀자리), 천평궁(천칭자리), 천갈궁(전갈자리), 인마궁(궁수자리), 마갈궁(염소자리), 보병궁(물병자리), 쌍어궁(물고기자리)이다.
zone|대|목성형 행성의 대기 중에서 압력이 큰 지역.
zone of avoidance|은하 회피대|은하수 근처의 티끌들에 의해서 다른 은하들이 모이지 않게 되는 지역.
